This game is a work of fiction. Any similarity to persons living or dead, or actual events is purely coincidental and was not the intent of the creator. Enjoy...

ISAAC 2
An Interactive Fiction by Shreeram Modi (baked__shrimp)
Release 1 / Serial number 210528 / Inform 7 build 6M62 (I6/v6.33 lib 6/12N) SD

Intro

This is a text adventure/interactive fiction game. Do you want a tutorial? (yes/no)

>look
Crime scene
As my eyes glanced over the scene I saw CG lying in front of me, and a dumpster to my north.

You can see CG here.

>x cg
I got down and looked at CG, trying to find anything that might lead me to find her murderer. I thought it would be best to check her arms, and her coat pocket.

>x cg arm
I only understood you as far as wanting to examine CG.

>x cg's arm
Which do you mean, CG's left arm or CG's right arm?

>left
I turned over her left arm, and I saw gashes all the way down it. Each gash I saw felt like a stab through my own heart.

>x cg's right arm
I held her right arm up to the lamplight, and in the yellow glow I saw a watch tan, but no watch. Had it been stolen?

>x cg
I got down and looked at CG, trying to find anything that might lead me to find her murderer. I thought it would be best to check her arms, and her coat pocket.

>x cg coat
I only understood you as far as wanting to examine CG.

>x cg's coat
I looked in her pocket and saw the corner of a neatly creased piece of paper sticking out.

>take paper
I unfolded the paper and saw a receipt from Jimmy's Bar. I knew where that was, I had been there a couple of times. It wasn't a place you'd go with your friends, but it was still a nice place. The owner wasn't too bad either, something I couldn't say about half the places I knew.

>look
Crime scene
As my eyes glanced over the scene I saw CG lying in front of me, and a dumpster to my north.

You can see CG here.

>n
End of alley
As I walked towards the end of the alley the walls around me loomed with their neverending height. It stank of rotten food and cigarettes, which all seemed to emanate from the dumpster in front of me. A glint from the dumpster caught my eye.

You can see Dumpster (closed) here.

>x dumpster
Apart from some vulgar graffiti, it was an unremarkable dumpster.

>open it
You open Dumpster, revealing Knife.

>take it
The dumpster's wheels were locked. It wouldn't move an inch.

>take knife
Looking through the dumpster I saw a knife tossed there, seemingly having fulfilled its purpose. Blood covered the blade and I shuddered thinking where it came from.

>inv
You are carrying:
  Clues
    Knife
    Receipt from Jimmy's Bar
    CG's body

* * *

This game is a work of fiction. Any similarity to persons living or dead, or actual events is purely coincidental and was not the intent of the creator. Enjoy...

ISAAC 2
An Interactive Fiction by Shreeram Modi (baked__shrimp)
Release 1 / Serial number 210528 / Inform 7 build 6M62 (I6/v6.33 lib 6/12N) SD

Intro

This is a text adventure/interactive fiction game. Do you want a tutorial? (yes/no)

>n
Please choose yes or no
This is a text adventure/interactive fiction game. Do you want a tutorial? (yes/no)

>open it
You open Dumpster, revealing Knife.

>take knife
Looking through the dumpster I saw a knife tossed there, seemingly having fulfilled its purpose. Blood covered the blade and I shuddered thinking where it came from.

>inv
You are carrying:
  Knife
  Clues

>x knife
A sharp chef's knife that I found in a dumpster near where CG was killed. It was covered in blood.

>s
Crime scene
As my eyes glanced over the scene I saw CG lying in front of me, and a dumpster to my north.

You can see CG here.

I beg your pardon?

>s
Crimson Way
I stepped out into the street, and felt the crackling of the lamp above me, like a barber's clippers slowly clipping away my sanity. The idle droning of cars was only cut short by a horn once in a while, breaking the monotony. If I remembered correctly Jimmy's Bar was a short walk east of here. I had never really gone west of the alley, that area tended to be too filled with hoodlums to warrant a visit. Maybe I could find CG's killer there?

>e
Front of Bar
Incandescent bulbs spilled their light over the entrance, bringing to attention the dilapidated and ignored posters on the glass wall. I could see that the inside was full of people, full of life, and the coldness of the outside hit me even harder. To the north of me stood Jimmy's Bar.

You can see Posters here.

>n
I stepped forward and a muscular gentleman held out his hand. He grunted in my direction, as if cueing me to say something.

Enter password:

>?
The bouncer stood there, it seemed I had gotten the password wrong.

* * *

>n
Please choose yes or no
This is a text adventure/interactive fiction game. Do you want a tutorial? (yes/no)

>no
Crime scene
I hadn't even known her for that long - CG - but her loss nonetheless pulled strings within my heart that I never knew existed. There she was, lying in the grimiest alleyway in Manhattan and all I could do was stand there powerlessly with my hands in my pockets like I was some chump schoolboy. I knew I had missed something important, more than just the death of a friend, but I was as lost as a jazz pianist in a vaudeville show. The only thing left for me to do would be to get revenge; if not for her sake then to rest my uneasy soul. As my eyes glanced over the scene I saw CG lying in front of me, and a dumpster to my north.

You can see CG here.

>s
Crimson Way
I stepped out into the street, and felt the crackling of the lamp above me, like a barber's clippers slowly clipping away my sanity. The idle droning of cars was only cut short by a horn once in a while, breaking the monotony. If I remembered correctly Jimmy's Bar was a short walk east of here. I had never really gone west of the alley, that area tended to be too filled with hoodlums to warrant a visit. Maybe I could find CG's killer there?

>w
Central Park
A hangout for all kinds of colorful characters and clueless tourists. Trees obscured my view from every direction, and I saw the usual goons scattered about. It was eerily quiet out; the only thing I could hear ofher than the crickets and creatures was the thumping of my own heart.

You can see Beavis here.

>e
Crimson Way
If I remembered correctly Jimmy's Bar was a short walk east of here. I had never really gone west of the alley, that area tended to be too filled with hoodlums to warrant a visit. Maybe I could find CG's killer there?

>e
Front of Bar
Incandescent bulbs spilled their light over the entrance, bringing to attention the dilapidated and ignored posters on the glass wall. I could see that the inside was full of people, full of life, and the coldness of the outside hit me even harder. To the north of me stood Jimmy's Bar.

You can see Posters here.

* * *

>n
I stepped forward and a muscular gentleman held out his hand. He grunted in my direction, as if cueing me to say something.

Enter password:

>swordfish
The bouncer stepped to the side, letting me pass.

>look
Front of Bar
To the north of me stood Jimmy's Bar.

You can see Posters here.

>n
Jimmys Bar
The comforting smell of fermented yeast and formaldehyde smothered me when I walked in. I knew the owner-Jimmy-personally, he was an old friend of mine, but as of recent times I hadn't been keeping up with him as much as I wished to. It had been a few months since I'd last seen him.

You can see Jimmy here.

>talk to jimmy
Jimmy ushered me to the side, greeting me with his usual bubbly greeting, "How've you been Isaac? I've been hearing of a new white rx7 that's been destroying all the locals. Have you seen it?

(1) - No, I haven't been out that much recently.
(2) - An rx7...?
(3) - Actually, I came here to talk to you about a different matter.

>1
That's not a verb I recognise.

(1) - No, I haven't been out that much recently.
(2) - An rx7...?
(3) - Actually, I came here to talk to you about a different matter.

>2
That's not a verb I recognise.

(1) - No, I haven't been out that much recently.
(2) - An rx7...?
(3) - Actually, I came here to talk to you about a different matter.

>3
That's not a verb I recognise.

(1) - No, I haven't been out that much recently.
(2) - An rx7...?
(3) - Actually, I came here to talk to you about a different matter.

>1
That's not a verb I recognise.

(1) - No, I haven't been out that much recently.
(2) - An rx7...?
(3) - Actually, I came here to talk to you about a different matter.

* * *

>swordfish
The bouncer stepped to the side, letting me pass.

>ne
You can't go that way.

>n
Jimmys Bar
The comforting smell of fermented yeast and formaldehyde smothered me when I walked in. I knew the owner-Jimmy-personally, he was an old friend of mine, but as of recent times I hadn't been keeping up with him as much as I wished to. It had been a few months since I'd last seen him.

You can see Jimmy here.

* * *

>swordfish
The bouncer stepped to the side, letting me pass.

>n
Jimmys Bar
The comforting smell of fermented yeast and formaldehyde smothered me when I walked in. I knew the owner-Jimmy-personally, he was an old friend of mine, but as of recent times I hadn't been keeping up with him as much as I wished to. It had been a few months since I'd last seen him.

You can see Jimmy here.

* * *

>2
That's not a verb I recognise.

(1) - No, I haven't been out that much recently.
(2) - An rx7...?
(3) - Actually, I came here to talk to you about a different matter.

>1
That's not a verb I recognise.

(1) - No, I haven't been out that much recently.
(2) - An rx7...?
(3) - Actually, I came here to talk to you about a different matter.

>bruh
That's not a verb I recognise.

(1) - No, I haven't been out that much recently.
(2) - An rx7...?
(3) - Actually, I came here to talk to you about a different matter.

>test
>--> No test scripts exist for this game.
(1) - No, I haven't been out that much recently.
(2) - An rx7...?
(3) - Actually, I came here to talk to you about a different matter.

>help
That's not a verb I recognise.

(1) - No, I haven't been out that much recently.
(2) - An rx7...?
(3) - Actually, I came here to talk to you about a different matter.

>n
You can't go that way.

(1) - No, I haven't been out that much recently.
(2) - An rx7...?
(3) - Actually, I came here to talk to you about a different matter.

>s
Front of Bar
To the north of me stood Jimmy's Bar.

You can see Posters here.

(1) - No, I haven't been out that much recently.
(2) - An rx7...?
(3) - Actually, I came here to talk to you about a different matter.

>n
Jimmys Bar
The comforting smell of fermented yeast and formaldehyde smothered me when I walked in. I knew the owner-Jimmy-personally, he was an old friend of mine, but as of recent times I hadn't been keeping up with him as much as I wished to. It had been a few months since I'd last seen him.

You can see Jimmy here.

(1) - No, I haven't been out that much recently.
(2) - An rx7...?
(3) - Actually, I came here to talk to you about a different matter.

* * *

>n
Jimmys Bar
The comforting smell of fermented yeast and formaldehyde smothered me when I walked in. I knew the owner-Jimmy-personally, he was an old friend of mine, but as of recent times I hadn't been keeping up with him as much as I wished to. It had been a few months since I'd last seen him.

You can see Jimmy here.

>ask jimmy
(for Clues)
(Jimmy first taking Clues)
Jimmy has better things to do.

>ask jimmy about the bar
Bar confirm

>ask jimmy
(for Clues)
(Jimmy first taking Clues)
Jimmy has better things to do.

>inv
You are carrying:
  Clues

* * *

>x cg
I got down and looked at CG, trying to find anything that might lead me to find her murderer. A thick pool of blood spilled out from her head, giving her a devilish halo. I thought it would be best to check her arms, and her coat pocket.

>x cg arm
I only understood you as far as wanting to examine CG.

* * *

>x cg's arm
Which do you mean, CG's left arm or CG's right arm?

>left
I turned over her left arm, but there was nothing there.

>right
That's not a verb I recognise.

>x cg's right
I held her right arm up to the lamplight, and in the yellow glow I saw a watch tan, but no watch. Had it been stolen?

>x cg coat
I only understood you as far as wanting to examine CG.

>x cg pocket
I looked in her pocket and saw the corner of a neatly creased piece of paper sticking out.

>take paper
I unfolded the paper and saw a receipt from Steve's Fine Establishment. I knew where that was, I had been there a couple of times. It wasn't a place you'd go with your friends, but it was still a nice place. The owner wasn't too bad either, something I couldn't say about half the places I knew.

>x paper
You see nothing special about the piece of paper.

>inv
You are carrying:
  Receipt from Steve's
  Clues
    CG's watch
    CG's body

>x Receipt
I found this receipt in CG's coat pocket. Steve's Fine Establishment was a lesser known hideway for nice folk and scum alike.

>n
End of alley
As I walked towards the end of the alley the walls around me loomed with their neverending height. It stank of rotten food and cigarettes, which all seemed to emanate from the dumpster in front of me.

A green dumpster sat still at the end of the alley.

>x dumpster
Apart from some vulgar graffiti, it was an unremarkable dumpster. A weird smell which could only be described as Indian food emanated from it.

>open dumpster
You open Dumpster, revealing Knife.

>take knife
Taken.

>inv
You are carrying:
  Knife
  Receipt from Steve's
  Clues
    CG's watch
    CG's body

>x knife
A sharp chef's knife that I found in a dumpster near where CG was killed. It was covered in blood.

* * *

>s
Crime scene
As my eyes glanced over the scene I saw CG lying in front of me, and a dumpster to my north.

You can see CG here.

>s
Crimson Way
I stepped out into the street, and felt the crackling of the lamp above me, like a barber's clippers slowly clipping away my sanity. The idle droning of cars was only cut short by a horn once in a while, breaking the monotony. If I remembered correctly Steve's Fine Establishment was a short walk east of here. I had never really gone west of the alley, that area tended to be too filled with hoodlums to warrant a visit. Maybe I could find CG's killer there? I also remembered Grove Street to my south, which had Rakesh's Indian Restaurant as well as an apartment complex.

>w
Central Park
A hangout for all kinds of colorful characters and clueless tourists. Trees obscured my view from every direction, and I saw the usual goons scattered about. It was eerily quiet out; the only thing I could hear ofher than the crickets and creatures was the thumping of my own heart. All around me I could see the paths of the park branching out like the branches of its many trees.

A bush stood next to Mike.

You can also see Mike here.

>talk to mike
"Yo Mike, what's up"

"Not much, not much."

>ask mike about steve's
There is no reply.

>l
Central Park
A hangout for all kinds of colorful characters and clueless tourists. Trees obscured my view from every direction, and I saw the usual goons scattered about. It was eerily quiet out; the only thing I could hear ofher than the crickets and creatures was the thumping of my own heart. All around me I could see the paths of the park branching out like the branches of its many trees.

A bush stood next to Mike.

You can also see Mike here.

>x bush
A common bush. Upon examination I noticed that there was a sports coat discarded inside it. Whoever left it must've been in a hurry because they didn't even try to conceal it.

>tkae coat
That's not a verb I recognise.

>take coat
Taken.

>inv
You are carrying:
  Sports coat
  Knife
  Receipt from Steve's
  Clues
    CG's watch
    CG's body

>x coat
This coat belongs to a man with no name. I found this coat tossed aside carelessly in a bush. It seemed like it had endured years of the New York hustle and bustle.

Sports coat's pocket contains Notebook.

>take notebook
Taken.

>x notebook
I opened the notebook up to a dog-eared page and saw written "1280 Crimson Way, Steve's. SWORDFISH" in a messy scrawl only meant to be understood by the writer.

>w
You can't go that way.

>w
You can't go that way.

>e
Mike sat back down on his bench.

Crimson Way
I stepped out into the street, and felt the crackling of the lamp above me, like a barber's clippers slowly clipping away my sanity. The idle droning of cars was only cut short by a horn once in a while, breaking the monotony. If I remembered correctly Steve's Fine Establishment was a short walk east of here. I had never really gone west of the alley, that area tended to be too filled with hoodlums to warrant a visit. Maybe I could find CG's killer there? I also remembered Grove Street to my south, which had Rakesh's Indian Restaurant as well as an apartment complex.

>e
Front of Steve's
Incandescent bulbs spilled their light over the entrance, bringing to attention the dilapidated and ignored posters on the glass wall. I could see that the inside was full of people, full of life, and the coldness of the outside hit me even harder. To the north of me stood Steve's Fine Establishment.

You can see Door to Steve's and Posters here.

>l
Front of Steve's
Incandescent bulbs spilled their light over the entrance, bringing to attention the dilapidated and ignored posters on the glass wall. I could see that the inside was full of people, full of life, and the coldness of the outside hit me even harder. To the north of me stood Steve's Fine Establishment.

You can see Door to Steve's and Posters here.

>n
I stepped forward and a muscular gentleman held out his hand. He grunted in my direction, as if cueing me to say something.

Enter password:

>SWORDFISH
The muscular gentleman grunted approvingly.

Steve's Fine Establishment
The comforting smell of flannel and fermented yeast smothered me when I walked in. I had heard about this place from a few of my friends, but had never actually visited it. Steve stood behind the table, tending to his customers. All around me people sat eating food and consuming fermented yeast in different flavors.

You can see Door to Steve's and Steve here.

>n
You can't go that way.

>talk to steve
"Hey Steve, how've you been?"

"Not too bad."

>ask steve about cg
"Have you seen CG around recently?"

"No, I haven't... But you know how she was, you could blink twice and she'd be gone."

>ask steve about receipt
"Wait a second. I found this receipt with CG... The receipt is from your place which means CG was here."

"Uh... yes it seems she was. Why were you peeking around in her stuff?"

Press for more info? (yes/no)

>yes
"Don't change the topic. Why was CG here?"

"Look I don't really know. She came here, stayed for a bit... Wait. There was one thing that was kind of suspicious, as soon as she saw a man running past she quickly left and went the other way. I don't know what that was all about, but it seemed like she knew him. While she was leaving, she dropped this piece of paper, I couldn't give it back to her."
Steve hands you CG's Note
"Ok, I have to go tend to some stuff, you really should leave."

Front of Steve's
Incandescent bulbs spilled their light over the entrance, bringing to attention the dilapidated and ignored posters on the glass wall. I could see that the inside was full of people, full of life, and the coldness of the outside hit me even harder. To the north of me stood Steve's Fine Establishment.

You can see Door to Steve's and Posters here.

Steve isn't here.

>x note
(CG's Note (Torn))
A note written distinctly in CG's handwriting. It reads "East from Grove Street
Knocks: three short knocks then two long knocks
Apartm-"
The note cuts off, the tear seems too precise to be an accident.

>s
You can't go that way.

>w
Crimson Way
I stepped out into the street, and felt the crackling of the lamp above me, like a barber's clippers slowly clipping away my sanity. The idle droning of cars was only cut short by a horn once in a while, breaking the monotony. If I remembered correctly Steve's Fine Establishment was a short walk east of here. I had never really gone west of the alley, that area tended to be too filled with hoodlums to warrant a visit. Maybe I could find CG's killer there? I also remembered Grove Street to my south, which had Rakesh's Indian Restaurant as well as an apartment complex.

>w
Central Park
A hangout for all kinds of colorful characters and clueless tourists. Trees obscured my view from every direction, and I saw the usual goons scattered about. It was eerily quiet out; the only thing I could hear ofher than the crickets and creatures was the thumping of my own heart. All around me I could see the paths of the park branching out like the branches of its many trees.

A bush stood next to Mike.

You can also see Mike here.

>s
You can't go that way.

>n
You can't go that way.

>w
You can't go that way.

>s
You can't go that way.

>l
Central Park
A hangout for all kinds of colorful characters and clueless tourists. Trees obscured my view from every direction, and I saw the usual goons scattered about. It was eerily quiet out; the only thing I could hear ofher than the crickets and creatures was the thumping of my own heart. All around me I could see the paths of the park branching out like the branches of its many trees.

A bush stood next to Mike.

You can also see Mike here.

>e
Crimson Way
I stepped out into the street, and felt the crackling of the lamp above me, like a barber's clippers slowly clipping away my sanity. The idle droning of cars was only cut short by a horn once in a while, breaking the monotony. If I remembered correctly Steve's Fine Establishment was a short walk east of here. I had never really gone west of the alley, that area tended to be too filled with hoodlums to warrant a visit. Maybe I could find CG's killer there? I also remembered Grove Street to my south, which had Rakesh's Indian Restaurant as well as an apartment complex.

>s
Grove Street
Slowly walking down the street I could feel the rain falling down on me, like a comforting blanket telling me that this was all some kind of twisted nightmare. As I passed faceless sheltered souls I couldn't help but think about one of those passing me by. I trudged on, passing these thoughts by as mere flickers of a cruelly optimistic imagination, trying to play tricks on me and distract me from my goal. I looked around and saw an old favorite restaurant of mine to the west, an Indian place that served the best chaat in NYC.

>n
Crimson Way
I stepped out into the street, and felt the crackling of the lamp above me, like a barber's clippers slowly clipping away my sanity. The idle droning of cars was only cut short by a horn once in a while, breaking the monotony. If I remembered correctly Steve's Fine Establishment was a short walk east of here. I had never really gone west of the alley, that area tended to be too filled with hoodlums to warrant a visit. Maybe I could find CG's killer there? I also remembered Grove Street to my south, which had Rakesh's Indian Restaurant as well as an apartment complex.

>e
Front of Steve's
Incandescent bulbs spilled their light over the entrance, bringing to attention the dilapidated and ignored posters on the glass wall. I could see that the inside was full of people, full of life, and the coldness of the outside hit me even harder. To the north of me stood Steve's Fine Establishment.

You can see Door to Steve's and Posters here.

>w
Crimson Way
I stepped out into the street, and felt the crackling of the lamp above me, like a barber's clippers slowly clipping away my sanity. The idle droning of cars was only cut short by a horn once in a while, breaking the monotony. If I remembered correctly Steve's Fine Establishment was a short walk east of here. I had never really gone west of the alley, that area tended to be too filled with hoodlums to warrant a visit. Maybe I could find CG's killer there? I also remembered Grove Street to my south, which had Rakesh's Indian Restaurant as well as an apartment complex.

>s
Grove Street
Slowly walking down the street I could feel the rain falling down on me, like a comforting blanket telling me that this was all some kind of twisted nightmare. As I passed faceless sheltered souls I couldn't help but think about one of those passing me by. I trudged on, passing these thoughts by as mere flickers of a cruelly optimistic imagination, trying to play tricks on me and distract me from my goal. I looked around and saw an old favorite restaurant of mine to the west, an Indian place that served the best chaat in NYC.

>l
Grove Street
Slowly walking down the street I could feel the rain falling down on me, like a comforting blanket telling me that this was all some kind of twisted nightmare. As I passed faceless sheltered souls I couldn't help but think about one of those passing me by. I trudged on, passing these thoughts by as mere flickers of a cruelly optimistic imagination, trying to play tricks on me and distract me from my goal. I looked around and saw an old favorite restaurant of mine to the west, an Indian place that served the best chaat in NYC.

>w
Front of Restaurant
I peered inside the window and saw an almost empty restaurant. It looked like the owner was just closing up for the night. I remembered Rakesh's, the food from there always reminded me of home, not just by its flavors, but by the heart that was put into its preparation. An old staple of New York, Rakesh's Indian Restaurant was to the west.

>w
Rakesh's Restaurant
The warm smell of fresh indian food hit my nose as soon as I waked in. I could see the store owner Rakesh behind his register, adding up the latest check.

You can see Rakesh and Register Drawer (closed) here.

>l
I noticed a torn scrap of paper on the ground it was torn in a pattern identical to CG's Note. As soon as I had noticed it, Rakesh picked it up and placed it in a drawer behind the cash register. If I wanted that note I would have to get him out of the restaurant first.

Rakesh's Restaurant
The warm smell of fresh indian food hit my nose as soon as I waked in. I could see the store owner Rakesh behind his register, adding up the latest check.

You can see Rakesh and Register Drawer (closed) here.

>talk to rakesh
"Hey Rakesh, how's the restaurant?

Rakesh continued sorting the register, unaware I even spoke.

>l
Rakesh's Restaurant
The warm smell of fresh indian food hit my nose as soon as I waked in. I could see the store owner Rakesh behind his register, adding up the latest check.

You can see Rakesh and Register Drawer (closed) here.

>l
Rakesh's Restaurant
The warm smell of fresh indian food hit my nose as soon as I waked in. I could see the store owner Rakesh behind his register, adding up the latest check.

You can see Rakesh and Register Drawer (closed) here.

>x register
You see nothing special about Register Drawer.

>n
You can't go that way.

>talk to rakesh
You are already talking to Rakesh.

>e
Rakesh continued punching numbers on his register.

Front of Restaurant
I peered inside the window and saw an almost empty restaurant. It looked like the owner was just closing up for the night. I remembered Rakesh's, the food from there always reminded me of home, not just by its flavors, but by the heart that was put into its preparation. An old staple of New York, Rakesh's Indian Restaurant was to the west.

>n
You can't go that way.

>e
Grove Street
Slowly walking down the street I could feel the rain falling down on me, like a comforting blanket telling me that this was all some kind of twisted nightmare. As I passed faceless sheltered souls I couldn't help but think about one of those passing me by. I trudged on, passing these thoughts by as mere flickers of a cruelly optimistic imagination, trying to play tricks on me and distract me from my goal. I looked around and saw an old favorite restaurant of mine to the west, an Indian place that served the best chaat in NYC.

>n
Crimson Way
I stepped out into the street, and felt the crackling of the lamp above me, like a barber's clippers slowly clipping away my sanity. The idle droning of cars was only cut short by a horn once in a while, breaking the monotony. If I remembered correctly Steve's Fine Establishment was a short walk east of here. I had never really gone west of the alley, that area tended to be too filled with hoodlums to warrant a visit. Maybe I could find CG's killer there? I also remembered Grove Street to my south, which had Rakesh's Indian Restaurant as well as an apartment complex.

>w
Central Park
A hangout for all kinds of colorful characters and clueless tourists. Trees obscured my view from every direction, and I saw the usual goons scattered about. It was eerily quiet out; the only thing I could hear ofher than the crickets and creatures was the thumping of my own heart. All around me I could see the paths of the park branching out like the branches of its many trees.

A bush stood next to Mike.

You can also see Mike here.

>ask mike about paper
Which do you mean, the piece of paper, Torn paper or Paper from Rakesh's?

>ask mike about rakesh paper
Mike turned to face me. 
There is no reply.

>ask mike about paper from rakesh's
There is no reply.

>ask mike about torn paper
Ask Mike for help distracting Rakesh? (yes/no)

>yes
"Hey Mike, I need some help from you. I think Rakesh, the guy who owns the Indian restaurant has something that I need."

"Indian restaurant? Oh yeah the one on Grove Street. Yeah, what do you need help with?"

"Can you keep the owner busy for a few minutes so I can get that paper?"

Mike thought for a bit, running his hands through his beard then saying, "I know one thing that might distract him, follow me." He started walking in the direction of the restaurant.

Front of Restaurant
I peered inside the window and saw an almost empty restaurant. It looked like the owner was just closing up for the night. I remembered Rakesh's, the food from there always reminded me of home, not just by its flavors, but by the heart that was put into its preparation. An old staple of New York, Rakesh's Indian Restaurant was to the west.

You can see Mike here.

Mike walked in, telling me to wait just around the corner. I peeked around, just managing to make out him walking up to Rakesh. I saw them exchanging some words. I couldn't exactly make out what they said, as the speech sonded muffled, like I was sitting inside a car watching the road go by. Both of them walked out, and I could finally hear what they were saying:
"No, not really. Ought is not a question of morality Rakesh. Here, let me give you an example, from the statement 'He is a captain' you can logically infer the conclusion that 'He ought to do whatever a captain ought to do'. That shows that an 'is' premise can entail an 'ought' conclusion."

"I still don't seem to understand."

"That's fine, I have some books in my study that I'll show you. You can borrow them and come right back to the restaurant."

I waited for a few seconds then saw Mike and Rakesh disappear around the corner.

>l
Front of Restaurant
I peered inside the window and saw an almost empty restaurant. It looked like the owner was just closing up for the night. I remembered Rakesh's, the food from there always reminded me of home, not just by its flavors, but by the heart that was put into its preparation. An old staple of New York, Rakesh's Indian Restaurant was to the west.

>w
Rakesh's Restaurant
The warm smell of fresh indian food hit my nose as soon as I waked in. 

You can see Register Drawer (closed) here.

>w
I looked around and noticed a small key on the register desk. Maybe Rakesh had left it behind?

You can't go that way.

>x register
Which do you mean, Register Key or Register Drawer?

>take key
Taken.

>open drawer
It seems to be locked.

>unlock register drawer using key
I didn't understand that sentence.

>unlock register drawer using register key
I didn't understand that sentence.

>unlock drawer
What do you want to unlock Register Drawer with?

>register key
You unlock Register Drawer.

>x drawer
You see nothing special about Register Drawer.

>open drawer
You open Register Drawer, revealing Money and Torn paper.

>take torn paper
Taken.

I noticed this torn scrap fit perfectly with the half of CG's note. I combined the two together to read "East from Grove Street
Knocks: three short knocks then two long knocks
Apartment 36"

>e
Front of Restaurant
I peered inside the window and saw an almost empty restaurant. It looked like the owner was just closing up for the night. I remembered Rakesh's, the food from there always reminded me of home, not just by its flavors, but by the heart that was put into its preparation. An old staple of New York, Rakesh's Indian Restaurant was to the west.

>s
You can't go that way.

>l
Front of Restaurant
I peered inside the window and saw an almost empty restaurant. It looked like the owner was just closing up for the night. I remembered Rakesh's, the food from there always reminded me of home, not just by its flavors, but by the heart that was put into its preparation. An old staple of New York, Rakesh's Indian Restaurant was to the west.

>e
Grove Street
Slowly walking down the street I could feel the rain falling down on me, like a comforting blanket telling me that this was all some kind of twisted nightmare. As I passed faceless sheltered souls I couldn't help but think about one of those passing me by. I trudged on, passing these thoughts by as mere flickers of a cruelly optimistic imagination, trying to play tricks on me and distract me from my goal. I looked around and saw an old favorite restaurant of mine to the west, an Indian place that served the best chaat in NYC.

>s
You can't go that way.

>e
Apartments
The flickering of the lights was in tune with the multitude of flies buzzing around them. I looked up the stairs and saw door after door, mirrored into the distance. The color of the walls reflected lower middle class America, but were so worn out you couldn't even tell.

You can see Doorbell here.

>x doorbell
I looked at the doorbell and saw the numbers 1 through 100, each with a name next to it as well as a button.

Which number apartment?

>36
Apartment 36, the name is scratched off...

Visit this apartment? (yes/no)

>yes
I walked up to apartment 36
Knock sequence:

>three short knocks then two long knocks
I walked up to apartment 36 and knocked on the door. The peephole opened and I heard a voice that seemed like it had just swallowed a spoonful of cinnamon.

"'n who exactly 're ya? tony pro said da guy who was supposed ta meet me would be wearin' a sports coat.  Get outta 'ere before come out there."

>open door
You can't see any such thing.

>inv
You are carrying:
  Register Key
  CG's Note
  Notebook
  Sports coat
  Knife
  Receipt from Steve's
  Clues
    Paper from Rakesh's
    Notebook Note
    CG's watch
    CG's body

>wear coat
You put on Sports coat.

>x doorbell
I looked at the doorbell and saw the numbers 1 through 100, each with a name next to it as well as a button.

Which number apartment?

* * *

>yes
I walked up to apartment 36
Knock sequence:

>three short knocks then two long knocks
I walked up to apartment 36 and knocked on the door. The peephole opened and I heard a voice that seemed like it had just swallowed a spoonful of cinnamon.

"Ah. Ya must be the guy Pro sent. Come on in."

The door opened and I looked inside to the musty room, half the wallpaper peeling off, and generic furniture giving it a fake lived-in feel. No sooner had I stepped in when the door shut behind me and Rakesh stepped out from the dark.

"Now, here's the thing."
His accent was as thick as his mustache.
"The things I hate the most are customers who dine and dash, and snoopers, and you just so happen to fall into the last category. Looks like me and my friend here are gonna need to have a bit of a chat with you."

I felt a cloth wrap around my face and was lulled into a sleep by the sweet smell of chloroform

>l
*** The End ***

Would you like to RESTART, RESTORE a saved game, QUIT or UNDO the last command?

>undo
Apartments
[Previous turn undone.]

>undo
Apartments
[Previous turn undone.]

Knock sequence:

>three short knocks then three long knocks
Silence. The door didn't even budge.

>look
Apartments
The flickering of the lights was in tune with the multitude of flies buzzing around them. I looked up the stairs and saw door after door, mirrored into the distance. The color of the walls reflected lower middle class America, but were so worn out you couldn't even tell.

You can see Doorbell here.

>inv
You are carrying:
  Register Key
  CG's Note
  Notebook
  Sports coat (being worn)
  Knife
  Receipt from Steve's
  Clues
    Paper from Rakesh's
    Notebook Note
    CG's watch
    CG's body

>x bell
You can't see any such thing.

>x doorbell
I looked at the doorbell and saw the numbers 1 through 100, each with a name next to it as well as a button.

Which number apartment?

* * *

>yes
I walked up to apartment 36
Knock sequence:

>three short knocks then three long knocks
Silence. The door didn't even budge.

>undo
Apartments
[Previous turn undone.]

Knock sequence:

>undo
Apartments
[Previous turn undone.]

Visit this apartment? (yes/no)

>undo
Apartments
[Previous turn undone.]

Which number apartment?

>undo
Apartments
[Previous turn undone.]

>dun
That's not a verb I recognise.

>undo
Apartments
[Previous turn undone.]

>undo
Apartments
[Previous turn undone.]

* * *

This game is a work of fiction. Any similarity to persons living or dead, or actual events is purely coincidental and was not the intent of the creator. Enjoy...

ISAAC 2
An Interactive Fiction by Shreeram Modi (baked__shrimp)
Release 1 / Serial number 210528 / Inform 7 build 6M62 (I6/v6.33 lib 6/12N) SD

Intro

This is a text adventure/interactive fiction game. Do you want a tutorial? (yes/no)

>help
I thought it would be best to get all the clues off CG before the flatfoots messed it all upThat's not a verb I recognise.

* * *

This game is a work of fiction. Any similarity to persons living or dead, or actual events is purely coincidental and was not the intent of the creator. Enjoy...

ISAAC 2
An Interactive Fiction by Shreeram Modi (baked__shrimp)
Release 1 / Serial number 210528 / Inform 7 build 6M62 (I6/v6.33 lib 6/12N) SD

Intro

This is a text adventure/interactive fiction game. Do you want a tutorial? (yes/no)

>y
That was a rhetorical question.

Do you want trigger warnings? (y/n)

>yes
The game is a murder mystery, and contains some graphic descriptions of violence.

That was a rhetorical question.

>yes
That was a rhetorical question.

>ok
That's not a verb I recognise.

* * *

This game is a work of fiction. Any similarity to persons living or dead, or actual events is purely coincidental and was not the intent of the creator. Enjoy...

ISAAC 2
An Interactive Fiction by Shreeram Modi (baked__shrimp)
Release 1 / Serial number 210528 / Inform 7 build 6M62 (I6/v6.33 lib 6/12N) SD

Intro

This is a text adventure/interactive fiction game. Do you want a tutorial? (yes/no)

>yes
Interactive fiction games involve controlling a character through text inputs instead of traditional WASD or mouse controls. These games have a few key commands that the player can use in order to interact with the environment, objects, or npc's. These commands are: (brackets indicate a shortened input that you can use)
North, East, South, West (n, e, s, w) - Moves your character in that direction
Examine (x) - examines a specified object
look (l) - examines your surroundings, the room you're in
open/close - opens/closes a container
take - takes an object
ask <person> about <something> - asks a person in the room you're in about a topic. These are all hardcoded so there's a chance you might need to change the wording a bit to get a response
Crime scene
I hadn't even known her for that long - CG - but her loss nonetheless pulled strings within my heart that I never knew existed. There she was, lying in the grimiest alleyway in Manhattan and all I could do was stand there powerlessly with my hands in my pockets like I was some chump schoolboy. I knew I had missed something important, more than just the death of a friend, but I was as lost as a jazz pianist in a vaudeville show. The only thing left for me to do would be to get revenge; if not for her sake then to rest my uneasy soul. As my eyes glanced over the scene I saw CG lying in front of me, and a dumpster to my north.

You can see CG here.

>no
*** Ok, have a good day :) ***

Would you like to RESTART, RESTORE a saved game, QUIT or UNDO the last command?

>restart
This game is a work of fiction. Any similarity to persons living or dead, or actual events is purely coincidental and was not the intent of the creator. Enjoy...
ISAAC 2
An Interactive Fiction by Shreeram Modi
Release 1 / Serial number 200507 / Inform 7 build 6M62 (I6/v6.33 lib 6/12N) SD

Intro

Do you want trigger warnings? (yes/no)

>no
Crime scene
I hadn't even known her for that long - CG - but her loss nonetheless pulled strings within my heart that I never knew existed. There she was, lying in the grimiest alleyway in Manhattan and all I could do was stand there powerlessly with my hands in my pockets like I was some chump schoolboy. I knew I had missed something important, more than just the death of a friend, but I was as lost as a jazz pianist in a vaudeville show. The only thing left for me to do would be to get revenge; if not for her sake then to rest my uneasy soul. As my eyes glanced over the scene I saw CG lying in front of me, and a dumpster to my north.

You can see CG here.

* * *

>restart
This game is a work of fiction. Any similarity to persons living or dead, or actual events is purely coincidental and was not the intent of the creator. Enjoy...
ISAAC 2
An Interactive Fiction by Shreeram Modi
Release 1 / Serial number 200507 / Inform 7 build 6M62 (I6/v6.33 lib 6/12N) SD

Intro

Do you want trigger warnings? (yes/no)

>yes
The game is a murder mystery, and contains some graphic descriptions of violence.

Do you want to play the game? (yes/no)

>yes
Crime scene
I hadn't even known her for that long - CG - but her loss nonetheless pulled strings within my heart that I never knew existed. There she was, lying in the grimiest alleyway in Manhattan and all I could do was stand there powerlessly with my hands in my pockets like I was some chump schoolboy. I knew I had missed something important, more than just the death of a friend, but I was as lost as a jazz pianist in a vaudeville show. The only thing left for me to do would be to get revenge; if not for her sake then to rest my uneasy soul. As my eyes glanced over the scene I saw CG lying in front of me, and a dumpster to my north.

You can see CG here.

* * *

>yes
That was a rhetorical question.

Do you want trigger warnings? (y/n)

>no
That was a rhetorical question.

Do you want trigger warnings? (y/n)

* * *

>s
Crimson Way
I stepped out into the street, and felt the crackling of the lamp above me, like a barber's clippers slowly clipping away my sanity. The idle droning of cars was only cut short by a horn once in a while, breaking the monotony. If I remembered correctly Steve's Fine Establishment was a short walk east of here. I had never really gone west of the alley, that area tended to be too filled with hoodlums to warrant a visit. Maybe I could find CG's killer there?

>w
Central Park
A hangout for all kinds of colorful characters and clueless tourists. Trees obscured my view from every direction, and I saw the usual goons scattered about. It was eerily quiet out; the only thing I could hear ofher than the crickets and creatures was the thumping of my own heart. All around me I could see the paths of the park branching out like the branches of its many trees.

A bush stood next to Mike.

You can also see Mike here.

>look
Central Park
 All around me I could see the paths of the park branching out like the branches of its many trees.

You can see Mike and Bush here.

>x bush
A common bush. Upon examination I noticed that there was a sports coat discarded inside it. Whoever left it must've been in a hurry because they didn't even try to conceal it.

>look
Central Park
 All around me I could see the paths of the park branching out like the branches of its many trees.

You can see Sports coat, Mike and Bush here.

>inv
You are carrying:
  Clues

>x coat
This coat belongs to a man with no name. I found this coat tossed aside carelessly in a bush. It seemed like it had endured years of the New York hustle and bustle.
Upon further inspection, it seemed that there was a small notebook in the inside pocket. I opened it up to a dog-eared page and saw written "1280 Crimson Way, Steve's. SWORDFISH"This coat belongs to a man with no name. I found this coat tossed aside carelessly in a bush. It seemed like it had endured years of the New York hustle and bustle.

* * *

>s
You can't go that way.

>e
Crimson Way
I stepped out into the street, and felt the crackling of the lamp above me, like a barber's clippers slowly clipping away my sanity. The idle droning of cars was only cut short by a horn once in a while, breaking the monotony. If I remembered correctly Steve's Fine Establishment was a short walk east of here. I had never really gone west of the alley, that area tended to be too filled with hoodlums to warrant a visit. Maybe I could find CG's killer there?

>s
Grove Street
Slowly walking down the street I could feel the rain falling down on me, like a comforting blanket telling me that this was all some kind of twisted nightmare. As I passed faceless sheltered souls I couldn't help but think about one of those passing me by. I trudged on, passing these thoughts by as mere flickers of a cruelly optimistic imagination, trying to play tricks on me and distract me from my goal. I looked around and saw an old favorite restaurant of mine to the west, an Indian place that served the best chaat.

>e
Apartments
The flickering of the lights was in tune with the multitude of flies buzzing around them. I looked up the stairs and saw door after door, mirrored into the distance. The color of the walls reflected lower middle class America, but were so worn out you couldn't even tell.

You can see Doorbell here.

* * *

>x doorbell
I looked at the doorbell and saw the numbers 1 through 100, each with a name next to it as well as a button.

Which number apartment?

>81
Apartment 81, a Mr. A. MacIntyre
Which number apartment?

* * *

>n
End of alley
As I walked towards the end of the alley the walls around me loomed with their neverending height. It stank of rotten food and cigarettes, which all seemed to emanate from the dumpster in front of me. A glint from the dumpster caught my eye.

A green dumpster sat still at the end of the alley.

>open dumpster
You open Dumpster, revealing Knife.

>t knife
There's no one here to talk to.

>tk knife
That's not a verb I recognise.

>ta knife
That's not a verb I recognise.

>knife
That's not a verb I recognise.

>s
Crime scene
As my eyes glanced over the scene I saw CG lying in front of me, and a dumpster to my north.

You can see CG here.

>w
You can't go that way.

>s
Crimson Way
I stepped out into the street, and felt the crackling of the lamp above me, like a barber's clippers slowly clipping away my sanity. The idle droning of cars was only cut short by a horn once in a while, breaking the monotony. If I remembered correctly Steve's Fine Establishment was a short walk east of here. I had never really gone west of the alley, that area tended to be too filled with hoodlums to warrant a visit. Maybe I could find CG's killer there?

I beg your pardon?

>w
Central Park
A hangout for all kinds of colorful characters and clueless tourists. Trees obscured my view from every direction, and I saw the usual goons scattered about. It was eerily quiet out; the only thing I could hear ofher than the crickets and creatures was the thumping of my own heart. All around me I could see the paths of the park branching out like the branches of its many trees.

Mike sat on a bench in front of me

A bush stood next to Mike.

>s
You can't go that way.

>w
You can't go that way.

>x bush
A common bush. Upon examination I noticed that there was a sports coat discarded inside it. Whoever left it must've been in a hurry because they didn't even try to conceal it.

>look
Central Park
All around me I could see the paths of the park branching out like the branches of its many trees.

Mike sat on a bench in front of me

A bush stood next to Mike.

You can also see Sports coat here.

I beg your pardon?

I beg your pardon?

>x coat
This coat belongs to a man with no name. I found this coat tossed aside carelessly in a bush. It seemed like it had endured years of the New York hustle and bustle.

Sports coat's pocket contains Notebook.

>x notebook
I opened the notebook up to a dog-eared page and saw written "1280 Crimson Way, Steve's. SWORDFISH" in a messy scrawl only meant to be understood by the writer.

>inv
You are carrying:
  Clues
    Notebook Note

>take coat
Taken.

>inv
You are carrying:
  Sports coat
  Clues
    Notebook Note

>take notebook
Which do you mean, Notebook or Notebook Note?

>notebook
Which do you mean, Notebook or Notebook Note?

>Notebook
Which do you mean, Notebook or Notebook Note?

>the Notebook
Which do you mean, Notebook or Notebook Note?

>stop
You can't see any such thing.

>take Notebook
Which do you mean, Notebook or Notebook Note?

>the first
You can't see any such thing.

>Notebook
That's not a verb I recognise.

>look
Central Park
All around me I could see the paths of the park branching out like the branches of its many trees.

Mike sat on a bench in front of me

A bush stood next to Mike.

>inv
You are carrying:
  Sports coat
  Clues
    Notebook Note

>x coat
This coat belongs to a man with no name. I found this coat tossed aside carelessly in a bush. It seemed like it had endured years of the New York hustle and bustle.

Sports coat's pocket contains Notebook.

>wear coat
You put on Sports coat.

>inv
You are carrying:
  Sports coat (being worn)
  Clues
    Notebook Note

* * *

This game is a work of fiction. Any similarity to persons living or dead, or actual events is purely coincidental and was not the intent of the creator. Enjoy...

ISAAC 2
An Interactive Fiction by Shreeram Modi (baked__shrimp)
Release 1 / Serial number 210528 / Inform 7 build 6M62 (I6/v6.33 lib 6/12N) SD

Intro

This is a text adventure/interactive fiction game. Do you want a tutorial? (yes/no)

>no
Crime scene
I hadn't even known her for that long - CG - but her loss nonetheless pulled strings within my heart that I never knew existed. There she was, lying in the grimiest alleyway in Manhattan and all I could do was stand there powerlessly with my hands in my pockets like I was some chump schoolboy. I knew I had missed something important, more than just the death of a friend, but I was as lost as a jazz pianist in a vaudeville show. The only thing left for me to do would be to get revenge; if not for her sake then to rest my uneasy soul. As my eyes glanced over the scene I saw CG lying in front of me, and a dumpster to my north.

You can see CG here.

>s
Crimson Way
I stepped out into the street, and felt the crackling of the lamp above me, like a barber's clippers slowly clipping away my sanity. The idle droning of cars was only cut short by a horn once in a while, breaking the monotony. If I remembered correctly Steve's Fine Establishment was a short walk east of here. I had never really gone west of the alley, that area tended to be too filled with hoodlums to warrant a visit. Maybe I could find CG's killer there? I also remembered Grove Street to my south, which had Rakesh's Indian Restaurant as well as an apartment complex.

>e
Front of Steve's
Incandescent bulbs spilled their light over the entrance, bringing to attention the dilapidated and ignored posters on the glass wall. I could see that the inside was full of people, full of life, and the coldness of the outside hit me even harder. To the north of me stood Steve's Fine Establishment.

You can see Door to Steve's and Posters here.

>n
I stepped forward and a muscular gentleman held out his hand. He grunted in my direction, as if cueing me to say something.

Enter password:

>swordfish
The muscular gentleman grunted approvingly.

Steve's Fine Establishment
The comforting smell of flannel and fermented yeast smothered me when I walked in. I had heard about this place from a few of my friends, but had never actually visited it. Steve stood behind the table, tending to his customers. All around me people sat eating food and consuming fermented yeast in different flavors.

You can see Door to Steve's and Steve here.

>n
Jimmys Bar
The comforting smell of fermented yeast and formaldehyde smothered me when I walked in. I knew the owner Jimmy personally, he was an old friend of mine, but as of recent times I hadn't been keeping up with him as much as I wished to. It had been a few months since I'd last seen him.

You can see Jimmy here.

>talk to jimmy
Jimmy ushered me to the side, greeting me with his usual bubbly greeting, "How've you been Isaac? I've been hearing of a new white rx7 that's been destroying all the locals. Have you seen it?
(1) - No, I haven't been out that much recently.
(2) - An rx7...?

(3) - Actually, I came here to talk to you about a different matter.

>1
That's not a verb I recognise.

(1) - No, I haven't been out that much recently.

* * *

>talk to jimmy
Jimmy ushered me to the side, greeting me with his usual bubbly greeting, "How've you been Isaac? I've been hearing of a new white rx7 that's been destroying all the locals. Have you seen it?
(1) - No, I haven't been out that much recently.
(2) - An rx7...?

(3) - Actually, I came here to talk to you about a different matter.

>s
1 fail

>bruh
That's not a verb I recognise.

>s
Front of Bar
To the north of me stood Jimmy's Bar.

You can see Posters here.

>n
Jimmys Bar
The comforting smell of fermented yeast and formaldehyde smothered me when I walked in. I knew the owner-Jimmy-personally, he was an old friend of mine, but as of recent times I hadn't been keeping up with him as much as I wished to. It had been a few months since I'd last seen him.

You can see Jimmy here.

* * *

>n
Jimmys Bar
The comforting smell of fermented yeast and formaldehyde smothered me when I walked in. I knew the owner Jimmy personally, he was an old friend of mine, but as of recent times I hadn't been keeping up with him as much as I wished to. It had been a few months since I'd last seen him.

You can see Jimmy here.

>ask jimmy
You could ask about The bar or Jimmys wife.

* * *

>what can I ask jimmy
You could ask about The bar or Jimmys wife.

>ask about jimmys wife
You can't see any such thing.

* * *

>n
Jimmys Bar
The comforting smell of fermented yeast and formaldehyde smothered me when I walked in. I knew the owner Jimmy personally, he was an old friend of mine, but as of recent times I hadn't been keeping up with him as much as I wished to. It had been a few months since I'd last seen him.

You can see Jimmy here.

>what can I ask jimmy
You could ask about the bar, news around town, or CG.

>ask jimmy about cg
"Have you talked to CG recently?"

"No, not really. She doesn't even come here that often. Why? Is something wrong?"

>ntntntntntnt
That's not a verb I recognise.

>bruh
That's not a verb I recognise.

>....
That's not a verb I recognise.

* * *

>n
Jimmys Bar
The comforting smell of fermented yeast and formaldehyde smothered me when I walked in. I knew the owner Jimmy personally, he was an old friend of mine, but as of recent times I hadn't been keeping up with him as much as I wished to. It had been a few months since I'd last seen him.

You can see Jimmy here.

>ask jimmy about cg
"Have you talked to CG recently?"

"No, not really. She doesn't even come here that often. Why? Is something wrong?"

>ask jimmy
You could ask about the bar, news around town, or CG.

>ask jimmy about cg
"Have you talked to CG recently?"

"No, not really. She doesn't even come here that often. Why? Is something wrong?"

* * *

>n
Jimmys Bar
The comforting smell of fermented yeast and formaldehyde smothered me when I walked in. I knew the owner Jimmy personally, he was an old friend of mine, but as of recent times I hadn't been keeping up with him as much as I wished to. It had been a few months since I'd last seen him.

You can see Jimmy here.

>tell jimmy about cg
Jimmy looked up from his bar
"Actually uh, Jimmy there's something I wanted to tell you..." The words stuck in my mouth like taffy on a hot Summer's day. It was as if by not saying them I could change what had already happened, "I found CG lying dead in an alleyway."

"DEAD?!?! H-how can that be? Do you know anything about it?"

* * *

>n
Jimmys Bar
The comforting smell of fermented yeast and formaldehyde smothered me when I walked in. I knew the owner Jimmy personally, he was an old friend of mine, but as of recent times I hadn't been keeping up with him as much as I wished to. It had been a few months since I'd last seen him.

You can see Jimmy here.

>talk to jimmy about knife
I only understood you as far as wanting to talk to Jimmy.

>ask jimmy about knife
Jimmy looked up from his bar
There is no reply.

* * *

>n
Jimmys Bar
The comforting smell of fermented yeast and formaldehyde smothered me when I walked in. I knew the owner Jimmy personally, he was an old friend of mine, but as of recent times I hadn't been keeping up with him as much as I wished to. It had been a few months since I'd last seen him.

You can see Jimmy here.

>tell jimmy about cg's watch
Jimmy looked up from his bar
This provokes no reaction.

>ask about cg's watch
There is no reply.

>s
Jimmy waved and went to another customer.

Front of Bar
To the north of me stood Jimmy's Bar.

You can see Posters here.

>w
Crimson Way
If I remembered correctly Jimmy's Bar was a short walk east of here. I had never really gone west of the alley, that area tended to be too filled with hoodlums to warrant a visit. Maybe I could find CG's killer there?

>w
Central Park
A hangout for all kinds of colorful characters and clueless tourists. Trees obscured my view from every direction, and I saw the usual goons scattered about. It was eerily quiet out; the only thing I could hear ofher than the crickets and creatures was the thumping of my own heart.

You can see Beavis here.

* * *

>e
Crimson Way
If I remembered correctly Jimmy's Bar was a short walk east of here. I had never really gone west of the alley, that area tended to be too filled with hoodlums to warrant a visit. Maybe I could find CG's killer there?

>n
Crime scene
As my eyes glanced over the scene I saw CG lying in front of me, and a dumpster to my north.

You can see CG here.

>n
End of alley
As I walked towards the end of the alley the walls around me loomed with their neverending height. It stank of rotten food and cigarettes, which all seemed to emanate from the dumpster in front of me. A glint from the dumpster caught my eye.

You can see Dumpster (closed) here.

>open dumpster
You open Dumpster, revealing Knife.

>x
(Clues)
I looked in my notebook and saw a list of clues that I had found so far.

>look
End of alley
A glint from the dumpster caught my eye.

You can see Dumpster (in which is Knife) here.

>take it
The dumpster's wheels were locked. It wouldn't move an inch.

* * *

>inv
You are carrying:
  Knife
  Clues

>drop knife
That's not a command I recognize.

>place knife in dumpster
That's not a verb I recognise.

>s
Crime scene
As my eyes glanced over the scene I saw CG lying in front of me, and a dumpster to my north.

You can see CG here.

>place knife in cg
That's not a verb I recognise.

>put knife in cg
That can't contain things.

>n
End of alley
A dumpster sat at the end of the alley. It stank of rotten food and cigarettes.

You can see Dumpster (empty) here.

>put knife in dumpster
You put Knife into Dumpster.

>inv
You are carrying:
  Clues

>put clues in dumpster
You put Clues into Dumpster.

>o.O
Sorry, that can't be corrected.

* * *

>swordfish
The muscular gentleman grunted approvingly.

Steve's Fine Establishment
The comforting smell of flannel and fermented yeast smothered me when I walked in. I had heard about this place from a few of my friends, but had never actually visited it. Steve stood behind the table, tending to his customers. All around me people sat eating food and consuming fermented yeast in different flavors.

You can see Door to Steve's and Steve here.

>look
Steve's Fine Establishment
Steve stood behind the table, tending to his customers. All around me people sat eating food and consuming fermented yeast in different flavors.

You can see Door to Steve's and Steve here.

>s
Front of Steve's
To the north of me stood Steve's Fine Establishment.

You can see Posters here.

* * *

>look
Steve's Fine Establishment
Steve stood behind the table, tending to his customers. All around me people sat eating food and consuming fermented yeast in different flavors.

You can see Door to Steve's and Steve here.

>open door
You open Door to Steve's.

>lock door
(with Clues)
First you would have to close Door to Steve's.

>close door to steve's
You close Door to Steve's.

>lock door
(with Clues)
That doesn't seem to fit the lock.

>s
(first opening Door to Steve's)

Front of Steve's
To the north of me stood Steve's Fine Establishment.

You can see Door to Steve's and Posters here.

>w
Crimson Way
If I remembered correctly Steve's Fine Establishment was a short walk east of here. I had never really gone west of the alley, that area tended to be too filled with hoodlums to warrant a visit. Maybe I could find CG's killer there?

>w
Central Park
A hangout for all kinds of colorful characters and clueless tourists. Trees obscured my view from every direction, and I saw the usual goons scattered about. It was eerily quiet out; the only thing I could hear ofher than the crickets and creatures was the thumping of my own heart. All around me I could see the paths of the park branching out like the branches of its many trees.

Mike sat on a bench in front of me

A bush stood next to Mike.

I beg your pardon?

>e
Crimson Way
If I remembered correctly Steve's Fine Establishment was a short walk east of here. I had never really gone west of the alley, that area tended to be too filled with hoodlums to warrant a visit. Maybe I could find CG's killer there?

>n
Crime scene
As my eyes glanced over the scene I saw CG lying in front of me, and a dumpster to my north.

You can see CG here.

* * *

>swordfish
The muscular gentleman grunted approvingly.

Steve's Fine Establishment
The comforting smell of flannel and fermented yeast smothered me when I walked in. I had heard about this place from a few of my friends, but had never actually visited it. Steve stood behind the table, tending to his customers. All around me people sat eating food and consuming fermented yeast in different flavors.

You can see Door to Steve's and Steve here.

>s
Front of Steve's
To the north of me stood Steve's Fine Establishment.

You can see Posters here.

>n
Steve's Fine Establishment
Steve stood behind the table, tending to his customers. All around me people sat eating food and consuming fermented yeast in different flavors.

You can see Steve here.

* * *

>ne
You can't go that way.

* * *

I beg your pardon?

>s
You can't go that way.

>look
Front of Steve's
To the north of me stood Steve's Fine Establishment.

You can see Posters here.

>w
Crimson Way
If I remembered correctly Steve's Fine Establishment was a short walk east of here. I had never really gone west of the alley, that area tended to be too filled with hoodlums to warrant a visit. Maybe I could find CG's killer there?

>look
Crimson Way
If I remembered correctly Steve's Fine Establishment was a short walk east of here. I had never really gone west of the alley, that area tended to be too filled with hoodlums to warrant a visit. Maybe I could find CG's killer there?

>e
Front of Steve's
To the north of me stood Steve's Fine Establishment.

You can see Posters here.

>look
Front of Steve's
To the north of me stood Steve's Fine Establishment.

You can see Posters here.

* * *

>n
Steve's Fine Establishment
Steve stood behind the table, tending to his customers. All around me people sat eating food and consuming fermented yeast in different flavors.

You can see Steve here.

>s
Front of Steve's
To the north of me stood Steve's Fine Establishment.

You can see Posters here.

* * *

>swordfish
The bouncer stepped to the side, letting me pass.

>n
Jimmys Bar
The comforting smell of fermented yeast and formaldehyde smothered me when I walked in. I knew the owner Jimmy personally, he was an old friend of mine, but as of recent times I hadn't been keeping up with him as much as I wished to. It had been a few months since I'd last seen him.

You can see Jimmy here.

>ask jimmy about CG
"Have you talked to CG recently?"

"No, not really. She doesn't even come here that often. Why? Is something wrong?"

>ask jimmy about CG
"Have you talked to CG recently?"

"No, not really. She doesn't even come here that often. Why? Is something wrong?"

* * *

>n
I stepped forward and a muscular gentleman held out his hand. He grunted in my direction, as if cueing me to say something.

Enter password:

>north
You can't go that way.

>look
Front of Steve's
To the north of me stood Steve's Fine Establishment.

>n
You can't go that way.

>n
You can't go that way.

>s
You can't go that way.

>e
You can't go that way.

>w
Crimson Way
If I remembered correctly Steve's Fine Establishment was a short walk east of here. I had never really gone west of the alley, that area tended to be too filled with hoodlums to warrant a visit. Maybe I could find CG's killer there?

>w
Central Park
A hangout for all kinds of colorful characters and clueless tourists. Trees obscured my view from every direction, and I saw the usual goons scattered about. It was eerily quiet out; the only thing I could hear ofher than the crickets and creatures was the thumping of my own heart. All around me I could see the paths of the park branching out like the branches of its many trees.

You can see Mike here.

* * *

>n
I stepped forward and a muscular gentleman held out his hand. He grunted in my direction, as if cueing me to say something.

Enter password:

>tsrts
The bouncer stood there; it seemed I had gotten the password wrong.

>w
Crimson Way
If I remembered correctly Steve's Fine Establishment was a short walk east of here. I had never really gone west of the alley, that area tended to be too filled with hoodlums to warrant a visit. Maybe I could find CG's killer there?

* * *

>w
Central Park
A hangout for all kinds of colorful characters and clueless tourists. Trees obscured my view from every direction, and I saw the usual goons scattered about. It was eerily quiet out; the only thing I could hear ofher than the crickets and creatures was the thumping of my own heart. All around me I could see the paths of the park branching out like the branches of its many trees.

You can see Mike here.

>ask mike about steve's
Mike turned to face me. 
There is no reply.

>ask mike about Front of Steve's
There is no reply.

>ask mike about Front of Steve's
There is no reply.

>ask mike about steve's
There is no reply.

* * *

>n
I stepped forward and a muscular gentleman held out his hand. He grunted in my direction, as if cueing me to say something.

Enter password:

>bruh
The bouncer stood there; it seemed I had gotten the password wrong.

>n
I stepped forward and a muscular gentleman held out his hand. He grunted in my direction, as if cueing me to say something.

Enter password:

>s
The bouncer stood there; it seemed I had gotten the password wrong.

>w
Crimson Way
If I remembered correctly Steve's Fine Establishment was a short walk east of here. I had never really gone west of the alley, that area tended to be too filled with hoodlums to warrant a visit. Maybe I could find CG's killer there?

* * *

>w
Central Park
A hangout for all kinds of colorful characters and clueless tourists. Trees obscured my view from every direction, and I saw the usual goons scattered about. It was eerily quiet out; the only thing I could hear ofher than the crickets and creatures was the thumping of my own heart. All around me I could see the paths of the park branching out like the branches of its many trees.

You can see Mike here.

I beg your pardon?

>ask mike about steve's
Mike turned to face me. 
There is no reply.

>ask mike about steve
There is no reply.

* * *

>w
Crimson Way
I stepped out into the street, and felt the crackling of the lamp above me, like a barber's clippers slowly clipping away my sanity. The idle droning of cars was only cut short by a horn once in a while, breaking the monotony. If I remembered correctly Steve's Fine Establishment was a short walk east of here. I had never really gone west of the alley, that area tended to be too filled with hoodlums to warrant a visit. Maybe I could find CG's killer there? I also remembered Grove Street to my south, which had Rakesh's Indian Restaurant as well as an apartment complex.

>n
Crime scene
As my eyes glanced over the scene I saw CG lying in front of me, and a dumpster to my north.

You can see CG here.

>s
Crimson Way
If I remembered correctly Jimmy's Bar was a short walk east of here. I had never really gone west of the alley, that area tended to be too filled with hoodlums to warrant a visit. Maybe I could find CG's killer there?

>e
Front of Bar
To the north of me stood Jimmy's Bar.

You can see Posters here.

>n
I stepped forward and a muscular gentleman held out his hand. He grunted in my direction, as if cueing me to say something.

Enter password:

* * *

>n
Jimmys Bar
The comforting smell of fermented yeast and formaldehyde smothered me when I walked in. I knew the owner Jimmy personally, he was an old friend of mine, but as of recent times I hadn't been keeping up with him as much as I wished to. It had been a few months since I'd last seen him.

You can see Jimmy here.

>ask jimmy about cg
Jimmy looked up from his bar
"Have you seen CG around recently?"

"No, I haven't... But you know how she was, you could blink twice and she'd be gone."

* * *

>w
Central Park
A hangout for all kinds of colorful characters and clueless tourists. Trees obscured my view from every direction, and I saw the usual goons scattered about. It was eerily quiet out; the only thing I could hear ofher than the crickets and creatures was the thumping of my own heart. All around me I could see the paths of the park branching out like the branches of its many trees.

A bush stood next to Mike.

You can also see Mike here.

I beg your pardon?

>ask mike about front of steve's
Mike turned to face me. 
There is no reply.

>ask mike about steve's
There is no reply.

>ask mike about End of alley
There is no reply.

>w
You can't go that way.

>e
Mike sat back down on his bench.

Crimson Way
If I remembered correctly Steve's Fine Establishment was a short walk east of here. I had never really gone west of the alley, that area tended to be too filled with hoodlums to warrant a visit. Maybe I could find CG's killer there?

I beg your pardon?

>e
Front of Steve's
To the north of me stood Steve's Fine Establishment.

You can see Posters here.

>x
(Clues)
I looked in my notebook and saw a list of clues that I had found so far.

>look
Front of Steve's
To the north of me stood Steve's Fine Establishment.

You can see Posters here.

* * *

>w
Crimson Way
If I remembered correctly Steve's Fine Establishment was a short walk east of here. I had never really gone west of the alley, that area tended to be too filled with hoodlums to warrant a visit. Maybe I could find CG's killer there?

>w
Central Park
 All around me I could see the paths of the park branching out like the branches of its many trees.

You can see Mike here.

>w
You can't go that way.

>ask mike about front of Steve's
Mike turned to face me. 
There is no reply.

>ask mike about cg
"Did you see CG any time recently? Specifically in the last few days?"

Mike thought for a second and said, "Hmm, I did see her pass through the park once, and there was a weird guy following her... I don't exactly remember what he looked like but he had a beige sports coat on, the type that you'd wear to be polite since you can't afford a proper suit."

"A strange man," I thought to myself, "this whole business was strange, not much about the man could make it stranger."

* * *

>w
Central Park
A hangout for all kinds of colorful characters and clueless tourists. Trees obscured my view from every direction, and I saw the usual goons scattered about. It was eerily quiet out; the only thing I could hear ofher than the crickets and creatures was the thumping of my own heart. All around me I could see the paths of the park branching out like the branches of its many trees.

A bush stood next to Mike.

You can also see Mike here.

>e
Crimson Way
I stepped out into the street, and felt the crackling of the lamp above me, like a barber's clippers slowly clipping away my sanity. The idle droning of cars was only cut short by a horn once in a while, breaking the monotony. If I remembered correctly Steve's Fine Establishment was a short walk east of here. I had never really gone west of the alley, that area tended to be too filled with hoodlums to warrant a visit. Maybe I could find CG's killer there?

* * *

>x doorbell
I looked at the doorbell and saw the numbers 1 through 100, each with a name next to it as well as a button.

Which number apartment?

>25
Apartment 25. The nameplate is empty.
That's not a verb I recognise.

Which number apartment?

* * *

>w
Crimson Way
I stepped out into the street, and felt the crackling of the lamp above me, like a barber's clippers slowly clipping away my sanity. The idle droning of cars was only cut short by a horn once in a while, breaking the monotony. If I remembered correctly Steve's Fine Establishment was a short walk east of here. I had never really gone west of the alley, that area tended to be too filled with hoodlums to warrant a visit. Maybe I could find CG's killer there? I also remembered Grove Street to my south, which had Rakesh's Indian Restaurant as well as an apartment complex.

I beg your pardon?

>w
Central Park
A hangout for all kinds of colorful characters and clueless tourists. Trees obscured my view from every direction, and I saw the usual goons scattered about. It was eerily quiet out; the only thing I could hear ofher than the crickets and creatures was the thumping of my own heart. All around me I could see the paths of the park branching out like the branches of its many trees.

A bush stood next to Mike.

You can also see Mike here.

>take coat
You can't see any such thing.

>x bush
A common bush. Upon examination I noticed that there was a sports coat discarded inside it. Whoever left it must've been in a hurry because they didn't even try to conceal it.

>take coat
Taken.

>wear coat
You put on Sports coat.

>s
You can't go that way.

>s
You can't go that way.

>e
Crimson Way
I stepped out into the street, and felt the crackling of the lamp above me, like a barber's clippers slowly clipping away my sanity. The idle droning of cars was only cut short by a horn once in a while, breaking the monotony. If I remembered correctly Steve's Fine Establishment was a short walk east of here. I had never really gone west of the alley, that area tended to be too filled with hoodlums to warrant a visit. Maybe I could find CG's killer there? I also remembered Grove Street to my south, which had Rakesh's Indian Restaurant as well as an apartment complex.

* * *

>s
Grove Street
Slowly walking down the street I could feel the rain falling down on me, like a comforting blanket telling me that this was all some kind of twisted nightmare. As I passed faceless sheltered souls I couldn't help but think about one of those passing me by. I trudged on, passing these thoughts by as mere flickers of a cruelly optimistic imagination, trying to play tricks on me and distract me from my goal. I looked around and saw an old favorite restaurant of mine to the west, an Indian place that served the best chaat in NYC.

>s
You can't go that way.

* * *

>three short knocks then three long knocks
Silence. The door didn't even budge.

>x doorbell
I looked at the doorbell and saw the numbers 1 through 100, each with a name next to it as well as a button.

Which number apartment?

* * *

I beg your pardon?

>x
What do you want to examine?

>l
*** The End ***

Would you like to RESTART, RESTORE a saved game, QUIT or UNDO the last command?

* * *

>e
Front of Steve's
Incandescent bulbs spilled their light over the entrance, bringing to attention the dilapidated and ignored posters on the glass wall. I could see that the inside was full of people, full of life, and the coldness of the outside hit me even harder. To the north of me stood Steve's Fine Establishment.

You can see Door to Steve's and Posters here.

>e
You can't go that way.

* * *

>w
Crimson Way
If I remembered correctly Steve's Fine Establishment was a short walk east of here. I had never really gone west of the alley, that area tended to be too filled with hoodlums to warrant a visit. Maybe I could find CG's killer there?

I beg your pardon?

>w
Central Park
A hangout for all kinds of colorful characters and clueless tourists. Trees obscured my view from every direction, and I saw the usual goons scattered about. It was eerily quiet out; the only thing I could hear ofher than the crickets and creatures was the thumping of my own heart. All around me I could see the paths of the park branching out like the branches of its many trees.

You can see Mike and Bush here.

>look
Central Park
 All around me I could see the paths of the park branching out like the branches of its many trees.

You can see Mike and Bush here.

* * *

>x bush
A common bush. Upon examination I noticed that there was a sports coat discarded inside it. Whoever left it must've been in a hurry because they didn't even try to conceal it.

>look
Central Park
 All around me I could see the paths of the park branching out like the branches of its many trees.

You can see Sports coat (in which is Notebook), Mike and Bush here.

>x notebook
I opened up a pocket in the coat and saw a small black notebook. Flipping to a dog-eared page I saw written "1280 Crimson Way, Steve's. SWORDFISH"

>e
Crimson Way
If I remembered correctly Steve's Fine Establishment was a short walk east of here. I had never really gone west of the alley, that area tended to be too filled with hoodlums to warrant a visit. Maybe I could find CG's killer there?

>e
Front of Steve's
To the north of me stood Steve's Fine Establishment.

You can see Posters here.

>inv
You are carrying:
  Clues
    Notebook

>x notebook
Flipping to a dog-eared page I saw written "1280 Crimson Way, Steve's. SWORDFISH"

* * *

>w
Central Park
A hangout for all kinds of colorful characters and clueless tourists. Trees obscured my view from every direction, and I saw the usual goons scattered about. It was eerily quiet out; the only thing I could hear ofher than the crickets and creatures was the thumping of my own heart. All around me I could see the paths of the park branching out like the branches of its many trees.

A bush stood next to Mike.

You can also see Mike here.

>ask mike about cg
Mike turned to face me. 
"Did you see CG any time recently? Specifically in the last few days?"

Mike thought for a second and said, "Hmm, I did see her pass through the park once, and there was a weird guy following her... I don't exactly remember what he looked like but he had a beige sports coat on, the type that you'd wear to be polite since you can't afford a proper suit.

>ask mike about the strange man
bruh

* * *

>w
Central Park
A hangout for all kinds of colorful characters and clueless tourists. Trees obscured my view from every direction, and I saw the usual goons scattered about. It was eerily quiet out; the only thing I could hear ofher than the crickets and creatures was the thumping of my own heart. All around me I could see the paths of the park branching out like the branches of its many trees.

A bush stood next to Mike.

You can also see Mike here.

>w
You can't go that way.

>x bush
A common bush.

>look
Central Park
 All around me I could see the paths of the park branching out like the branches of its many trees.

You can see Mike and Bush here.

>x bush
A common bush.

* * *

>w
You can't go that way.

I beg your pardon?

>look
Central Park
 All around me I could see the paths of the park branching out like the branches of its many trees.

You can see Mike and Bush here.

* * *

>look
Central Park
 All around me I could see the paths of the park branching out like the branches of its many trees.

You can see Sports coat, Mike and Bush here.

>x coat
This coat belongs to a man with no name.

>look
Central Park
 All around me I could see the paths of the park branching out like the branches of its many trees.

You can see Mike and Bush here.

* * *

>inv
You are carrying:
  Clues

>x coat
This coat belongs to a man with no name.

>inv
You are carrying:
  Clues
    Sports coat

>e
Crimson Way
If I remembered correctly Steve's Fine Establishment was a short walk east of here. I had never really gone west of the alley, that area tended to be too filled with hoodlums to warrant a visit. Maybe I could find CG's killer there?

>inv
You are carrying:
  Clues
    Sports coat

>x sports coat
This coat belongs to a man with no name.

>x coat
This coat belongs to a man with no name.

* * *

>w
You can't go that way.

>look
Central Park
All around me I could see the paths of the park branching out like the branches of its many trees.

You can see Mike and Bush here.

>x bush
A common bush. Upon examination I noticed that there was a sports coat discarded inside it. Whoever left it must've been in a hurry because they didn't even try to conceal it.

* * *

>look
Central Park
 All around me I could see the paths of the park branching out like the branches of its many trees.

You can see Sports coat, Mike and Bush here.

>x sports coat
This coat belongs to a man with no name.

>inv
You are carrying:
  Clues
    Sports coat

>look
Central Park
 All around me I could see the paths of the park branching out like the branches of its many trees.

You can see Mike and Bush here.

* * *

>look
Central Park
All around me I could see the paths of the park branching out like the branches of its many trees.

You can see Mike and Bush here.

>inv
You are carrying:
  Clues

>x bush
A common bush. Upon examination I noticed that there was a sports coat discarded inside it. Whoever left it must've been in a hurry because they didn't even try to conceal it.

>look
Central Park
All around me I could see the paths of the park branching out like the branches of its many trees.

You can see Sports coat, Mike and Bush here.

>x coat
This coat belongs to a man with no name. I found this coat tossed aside carelessly in a bush. It seemed like it had endured years of the New York hustle and bustle.
Upon further inspection, it seemed that there was a small notebook in the inside pocket. I opened it up to a dog-eared page and saw written "1280 Crimson Way, Steve's. SWORDFISH"

>look
Central Park
All around me I could see the paths of the park branching out like the branches of its many trees.

You can see Sports coat, Mike and Bush here.

>inv
You are carrying:
  Clues
    Notebook

* * *

>x notebook
Flipping to a dog-eared page I saw written "1280 Crimson Way, Steve's. SWORDFISH"

>take coat
Taken.

>inv
You are carrying:
  Sports coat
  Clues
    Notebook

>wear coat
You can't wear that!

* * *

>w
Central Park
A hangout for all kinds of colorful characters and clueless tourists. Trees obscured my view from every direction, and I saw the usual goons scattered about. It was eerily quiet out; the only thing I could hear ofher than the crickets and creatures was the thumping of my own heart. All around me I could see the paths of the park branching out like the branches of its many trees.

A bush stood next to Mike.

You can also see Mike here.

>x bush
A common bush. Upon examination I noticed that there was a sports coat discarded inside it. Whoever left it must've been in a hurry because they didn't even try to conceal it.

* * *

>look
Central Park
 All around me I could see the paths of the park branching out like the branches of its many trees.

You can see Sports coat (in which is Notebook), Mike and Bush here.

>x coat
This coat belongs to a man with no name.

>inv
You are carrying:
  Clues
    Sports coat
      Notebook

>e
Crimson Way
If I remembered correctly Steve's Fine Establishment was a short walk east of here. I had never really gone west of the alley, that area tended to be too filled with hoodlums to warrant a visit. Maybe I could find CG's killer there?

>in
You can't go that way.

>inv
You are carrying:
  Clues
    Sports coat
      Notebook

>x coat
This coat belongs to a man with no name.

* * *

>x sports coat
This coat belongs to a man with no name.

>e
Crimson Way
If I remembered correctly Steve's Fine Establishment was a short walk east of here. I had never really gone west of the alley, that area tended to be too filled with hoodlums to warrant a visit. Maybe I could find CG's killer there?

>inv
You are carrying:
  Clues
    Strange Coat

>w
Central Park
 All around me I could see the paths of the park branching out like the branches of its many trees.

You can see Sports coat, Mike and Bush here.

>inv
You are carrying:
  Clues
    Strange Coat

>x coat
(Sports coat)
This coat belongs to a man with no name.

>x strange coat
You see nothing special about Strange Coat.

* * *

>e
Crimson Way
I stepped out into the street, and felt the crackling of the lamp above me, like a barber's clippers slowly clipping away my sanity. The idle droning of cars was only cut short by a horn once in a while, breaking the monotony. If I remembered correctly Steve's Fine Establishment was a short walk east of here. I had never really gone west of the alley, that area tended to be too filled with hoodlums to warrant a visit. Maybe I could find CG's killer there?

>w
Central Park
All around me I could see the paths of the park branching out like the branches of its many trees.

Mike sat on a bench in front of me

A bush stood next to Mike.

testing

>s
You can't go that way.

testing

>e
Crimson Way
If I remembered correctly Steve's Fine Establishment was a short walk east of here. I had never really gone west of the alley, that area tended to be too filled with hoodlums to warrant a visit. Maybe I could find CG's killer there?

testing

>s
Grove Street
Slowly walking down the street I could feel the rain falling down on me, like a comforting blanket telling me that this was all some kind of twisted nightmare. As I passed faceless sheltered souls I couldn't help but think about one of those passing me by. I trudged on, passing these thoughts by as mere flickers of a cruelly optimistic imagination, trying to play tricks on me and distract me from my goal. I looked around and saw an old favorite restaurant of mine to the west, an Indian place that served the best chaat.

testing

>w
Front of Restaurant
I peered inside and saw people packed inside. Families enthralled in conversation packed the restaurant, filling it with an atmosphere reminiscent of incense. The food from there always reminded me of home, not by the flavors, but by the heart that was put into its preparation. An old staple of New York, Rakesh's Indian Restaurant was to the west.

testing

>w
Rakesh's Restaurant
The warm smell of fresh indian food hit my nose as soon as I waked in.

You can see a Radio here.

testing

>n
You can't go that way.

testing

>map
That's not a verb I recognise.

* * *

>s
Grove Street
Slowly walking down the street I could feel the rain falling down on me, like a comforting blanket telling me that this was all some kind of twisted nightmare. As I passed faceless sheltered souls I couldn't help but think about one of those passing me by. I trudged on, passing these thoughts by as mere flickers of a cruelly optimistic imagination, trying to play tricks on me and distract me from my goal. I looked around and saw an old favorite restaurant of mine to the west, an Indian place that served the best chaat.

>look
Grove Street
Slowly walking down the street I could feel the rain falling down on me, like a comforting blanket telling me that this was all some kind of twisted nightmare. As I passed faceless sheltered souls I couldn't help but think about one of those passing me by. I trudged on, passing these thoughts by as mere flickers of a cruelly optimistic imagination, trying to play tricks on me and distract me from my goal. I looked around and saw an old favorite restaurant of mine to the west, an Indian place that served the best chaat.

>w
Front of Restaurant
I peered inside and saw people packed inside. Families enthralled in conversation packed the restaurant, filling it with an atmosphere reminiscent of incense. The food from there always reminded me of home, not by the flavors, but by the heart that was put into its preparation. An old staple of New York, Rakesh's Indian Restaurant was to the west.

>w
Rakesh's Restaurant
The warm smell of fresh indian food hit my nose as soon as I waked in. As I looked around I noticed a torn piece of paper on the ground. No sooner had I noticed it, the owner Rakesh picked it up and placed it in one of the drawers behind the register.

>e
Front of Restaurant
I peered inside and saw people packed inside. Families enthralled in conversation packed the restaurant, filling it with an atmosphere reminiscent of incense. The food from there always reminded me of home, not by the flavors, but by the heart that was put into its preparation. An old staple of New York, Rakesh's Indian Restaurant was to the west.

>n
You can't go that way.

>e
Grove Street
Slowly walking down the street I could feel the rain falling down on me, like a comforting blanket telling me that this was all some kind of twisted nightmare. As I passed faceless sheltered souls I couldn't help but think about one of those passing me by. I trudged on, passing these thoughts by as mere flickers of a cruelly optimistic imagination, trying to play tricks on me and distract me from my goal. I looked around and saw an old favorite restaurant of mine to the west, an Indian place that served the best chaat.

>n
Crimson Way
I stepped out into the street, and felt the crackling of the lamp above me, like a barber's clippers slowly clipping away my sanity. The idle droning of cars was only cut short by a horn once in a while, breaking the monotony. If I remembered correctly Steve's Fine Establishment was a short walk east of here. I had never really gone west of the alley, that area tended to be too filled with hoodlums to warrant a visit. Maybe I could find CG's killer there?

>n
Crime scene
As my eyes glanced over the scene I saw CG lying in front of me, and a dumpster to my north.

You can see CG here.

>x cg coat pocket
I only understood you as far as wanting to examine CG.

>x cg pocket
I looked in her pocket and saw the corner of a neatly creased piece of paper sticking out.

* * *

>take paper
I unfolded the paper and saw a receipt from Steve's Fine Establishment. I knew where that was, I had been there a couple of times. It wasn't a place you'd go with your friends, but it was still a nice place. The owner wasn't too bad either, something I couldn't say about half the places I knew.

>s
Crimson Way
I stepped out into the street, and felt the crackling of the lamp above me, like a barber's clippers slowly clipping away my sanity. The idle droning of cars was only cut short by a horn once in a while, breaking the monotony. If I remembered correctly Steve's Fine Establishment was a short walk east of here. I had never really gone west of the alley, that area tended to be too filled with hoodlums to warrant a visit. Maybe I could find CG's killer there?

>inv
You are carrying:
  Receipt from Steve's
  Clues

>w
Central Park
A hangout for all kinds of colorful characters and clueless tourists. Trees obscured my view from every direction, and I saw the usual goons scattered about. It was eerily quiet out; the only thing I could hear ofher than the crickets and creatures was the thumping of my own heart. All around me I could see the paths of the park branching out like the branches of its many trees.

Mike sat on a bench in front of me

A bush stood next to Mike.

>n
You can't go that way.

>e
Crimson Way
I stepped out into the street, and felt the crackling of the lamp above me, like a barber's clippers slowly clipping away my sanity. The idle droning of cars was only cut short by a horn once in a while, breaking the monotony. If I remembered correctly Steve's Fine Establishment was a short walk east of here. I had never really gone west of the alley, that area tended to be too filled with hoodlums to warrant a visit. Maybe I could find CG's killer there?

>e
Front of Steve's
Incandescent bulbs spilled their light over the entrance, bringing to attention the dilapidated and ignored posters on the glass wall. I could see that the inside was full of people, full of life, and the coldness of the outside hit me even harder. To the north of me stood Steve's Fine Establishment.

You can see Door to Steve's and Posters here.

* * *

>e
You can't go that way.

>n
I stepped forward and a muscular gentleman held out his hand. He grunted in my direction, as if cueing me to say something.

Enter password:

* * *

>swordfish
The muscular gentleman grunted approvingly.

Steve's Fine Establishment
The comforting smell of flannel and fermented yeast smothered me when I walked in. I had heard about this place from a few of my friends, but had never actually visited it. Steve stood behind the table, tending to his customers. All around me people sat eating food and consuming fermented yeast in different flavors.

You can see Door to Steve's and Steve here.

>ask steve about receipt
Steve looked up from his table
"Wait a second. I found this receipt with CG... The receipt is from your place which means CG was here."

"Uh... yes it seems she was. Why were you peeking around in her stuff?"

Press for more info? (yes/no)

>yes
That was a rhetorical question.

Press for more info? (yes/no)

>yes
That was a rhetorical question.

Press for more info? (yes/no)

>no
That was a rhetorical question.

Press for more info? (yes/no)

>tsr
That's not a verb I recognise.

Press for more info? (yes/no)

>tsrtsrtsr
That's not a verb I recognise.

Press for more info? (yes/no)

>tsrtsrtsr
That's not a verb I recognise.

Press for more info? (yes/no)

>tsrtsr
That's not a verb I recognise.

Press for more info? (yes/no)

>no
That was a rhetorical question.

Press for more info? (yes/no)

>no
That was a rhetorical question.

Press for more info? (yes/no)

>yes
That was a rhetorical question.

Press for more info? (yes/no)

* * *

>l
Central Park
A hangout for all kinds of colorful characters and clueless tourists. Trees obscured my view from every direction, and I saw the usual goons scattered about. It was eerily quiet out; the only thing I could hear ofher than the crickets and creatures was the thumping of my own heart. All around me I could see the paths of the park branching out like the branches of its many trees.

A bush stood next to Mike.

You can also see Mike here.

>look
Central Park
A hangout for all kinds of colorful characters and clueless tourists. Trees obscured my view from every direction, and I saw the usual goons scattered about. It was eerily quiet out; the only thing I could hear ofher than the crickets and creatures was the thumping of my own heart. All around me I could see the paths of the park branching out like the branches of its many trees.

A bush stood next to Mike.

You can also see Mike here.

>e
Crimson Way
I stepped out into the street, and felt the crackling of the lamp above me, like a barber's clippers slowly clipping away my sanity. The idle droning of cars was only cut short by a horn once in a while, breaking the monotony. If I remembered correctly Steve's Fine Establishment was a short walk east of here. I had never really gone west of the alley, that area tended to be too filled with hoodlums to warrant a visit. Maybe I could find CG's killer there?

>s
Grove Street
Slowly walking down the street I could feel the rain falling down on me, like a comforting blanket telling me that this was all some kind of twisted nightmare. As I passed faceless sheltered souls I couldn't help but think about one of those passing me by. I trudged on, passing these thoughts by as mere flickers of a cruelly optimistic imagination, trying to play tricks on me and distract me from my goal. I looked around and saw an old favorite restaurant of mine to the west, an Indian place that served the best chaat in NYC.

>w
Front of Restaurant
I peered inside the window and saw an almost empty restaurant. It looked like the owner was just closing up for the night. I remembered Rakesh's, the food from there always reminded me of home, not just by its flavors, but by the heart that was put into its preparation. An old staple of New York, Rakesh's Indian Restaurant was to the west.

>look
Front of Restaurant
I peered inside the window and saw an almost empty restaurant. It looked like the owner was just closing up for the night. I remembered Rakesh's, the food from there always reminded me of home, not just by its flavors, but by the heart that was put into its preparation. An old staple of New York, Rakesh's Indian Restaurant was to the west.

>look
Front of Restaurant
I peered inside the window and saw an almost empty restaurant. It looked like the owner was just closing up for the night. I remembered Rakesh's, the food from there always reminded me of home, not just by its flavors, but by the heart that was put into its preparation. An old staple of New York, Rakesh's Indian Restaurant was to the west.

>x register
You can't see any such thing.

>x rakesh
You can't see any such thing.

>ask rakesh about cg
You can't see any such thing.

>e
Grove Street
Slowly walking down the street I could feel the rain falling down on me, like a comforting blanket telling me that this was all some kind of twisted nightmare. As I passed faceless sheltered souls I couldn't help but think about one of those passing me by. I trudged on, passing these thoughts by as mere flickers of a cruelly optimistic imagination, trying to play tricks on me and distract me from my goal. I looked around and saw an old favorite restaurant of mine to the west, an Indian place that served the best chaat in NYC.

>n
Crimson Way
I stepped out into the street, and felt the crackling of the lamp above me, like a barber's clippers slowly clipping away my sanity. The idle droning of cars was only cut short by a horn once in a while, breaking the monotony. If I remembered correctly Steve's Fine Establishment was a short walk east of here. I had never really gone west of the alley, that area tended to be too filled with hoodlums to warrant a visit. Maybe I could find CG's killer there?

>w
Central Park
A hangout for all kinds of colorful characters and clueless tourists. Trees obscured my view from every direction, and I saw the usual goons scattered about. It was eerily quiet out; the only thing I could hear ofher than the crickets and creatures was the thumping of my own heart. All around me I could see the paths of the park branching out like the branches of its many trees.

A bush stood next to Mike.

You can also see Mike here.

>ask mike about torn paper
Mike turned to face me. 
There is no reply.

>e
Mike sat back down on his bench.

Crimson Way
I stepped out into the street, and felt the crackling of the lamp above me, like a barber's clippers slowly clipping away my sanity. The idle droning of cars was only cut short by a horn once in a while, breaking the monotony. If I remembered correctly Steve's Fine Establishment was a short walk east of here. I had never really gone west of the alley, that area tended to be too filled with hoodlums to warrant a visit. Maybe I could find CG's killer there?

>e
Front of Steve's
Incandescent bulbs spilled their light over the entrance, bringing to attention the dilapidated and ignored posters on the glass wall. I could see that the inside was full of people, full of life, and the coldness of the outside hit me even harder. To the north of me stood Steve's Fine Establishment.

You can see Door to Steve's and Posters here.

* * *

>swordfish
The muscular gentleman grunted approvingly.

Steve's Fine Establishment
The comforting smell of flannel and fermented yeast smothered me when I walked in. I had heard about this place from a few of my friends, but had never actually visited it. Steve stood behind the table, tending to his customers. All around me people sat eating food and consuming fermented yeast in different flavors.

You can see Door to Steve's and Steve here.

>look
Steve's Fine Establishment
The comforting smell of flannel and fermented yeast smothered me when I walked in. I had heard about this place from a few of my friends, but had never actually visited it. Steve stood behind the table, tending to his customers. All around me people sat eating food and consuming fermented yeast in different flavors.

You can see Door to Steve's and Steve here.

>x steve
You see nothing special about Steve.

>e
You can't go that way.

>s
(first opening Door to Steve's)

Front of Steve's
Incandescent bulbs spilled their light over the entrance, bringing to attention the dilapidated and ignored posters on the glass wall. I could see that the inside was full of people, full of life, and the coldness of the outside hit me even harder. To the north of me stood Steve's Fine Establishment.

You can see Door to Steve's and Posters here.

>w
Crimson Way
I stepped out into the street, and felt the crackling of the lamp above me, like a barber's clippers slowly clipping away my sanity. The idle droning of cars was only cut short by a horn once in a while, breaking the monotony. If I remembered correctly Steve's Fine Establishment was a short walk east of here. I had never really gone west of the alley, that area tended to be too filled with hoodlums to warrant a visit. Maybe I could find CG's killer there?

>s
Grove Street
Slowly walking down the street I could feel the rain falling down on me, like a comforting blanket telling me that this was all some kind of twisted nightmare. As I passed faceless sheltered souls I couldn't help but think about one of those passing me by. I trudged on, passing these thoughts by as mere flickers of a cruelly optimistic imagination, trying to play tricks on me and distract me from my goal. I looked around and saw an old favorite restaurant of mine to the west, an Indian place that served the best chaat in NYC.

* * *

>w
Front of Restaurant
I peered inside the window and saw an almost empty restaurant. It looked like the owner was just closing up for the night. I remembered Rakesh's, the food from there always reminded me of home, not just by its flavors, but by the heart that was put into its preparation. An old staple of New York, Rakesh's Indian Restaurant was to the west.

>x register
You can't see any such thing.

>w
Rakesh's Restaurant
The warm smell of fresh indian food hit my nose as soon as I waked in. I could see the store owner Rakesh behind his register, adding up the latest check.

You can see Rakesh and Register Drawer (closed) here.

>x register
I noticed a torn scrap of paper on the ground. As soon as I had noticed it, Rakesh picked it up and placed it in a drawer behind the cash register. If I wanted that note I would have to get him out of the restaurant first.

You see nothing special about Register Drawer.

>e
Front of Restaurant
I peered inside the window and saw an almost empty restaurant. It looked like the owner was just closing up for the night. I remembered Rakesh's, the food from there always reminded me of home, not just by its flavors, but by the heart that was put into its preparation. An old staple of New York, Rakesh's Indian Restaurant was to the west.

>n
You can't go that way.

>w
Rakesh's Restaurant
The warm smell of fresh indian food hit my nose as soon as I waked in. I could see the store owner Rakesh behind his register, adding up the latest check.

You can see Rakesh and Register Drawer (closed) here.

>e
Front of Restaurant
I peered inside the window and saw an almost empty restaurant. It looked like the owner was just closing up for the night. I remembered Rakesh's, the food from there always reminded me of home, not just by its flavors, but by the heart that was put into its preparation. An old staple of New York, Rakesh's Indian Restaurant was to the west.

* * *

>w
Rakesh's Restaurant
The warm smell of fresh indian food hit my nose as soon as I waked in. I could see the store owner Rakesh behind his register, adding up the latest check.

You can see Rakesh and Register Drawer (closed) here.

>w
You can't go that way.

>e
Front of Restaurant
I peered inside the window and saw an almost empty restaurant. It looked like the owner was just closing up for the night. I remembered Rakesh's, the food from there always reminded me of home, not just by its flavors, but by the heart that was put into its preparation. An old staple of New York, Rakesh's Indian Restaurant was to the west.

>e
Grove Street
Slowly walking down the street I could feel the rain falling down on me, like a comforting blanket telling me that this was all some kind of twisted nightmare. As I passed faceless sheltered souls I couldn't help but think about one of those passing me by. I trudged on, passing these thoughts by as mere flickers of a cruelly optimistic imagination, trying to play tricks on me and distract me from my goal. I looked around and saw an old favorite restaurant of mine to the west, an Indian place that served the best chaat in NYC.

* * *

>w
Central Park
A hangout for all kinds of colorful characters and clueless tourists. Trees obscured my view from every direction, and I saw the usual goons scattered about. It was eerily quiet out; the only thing I could hear ofher than the crickets and creatures was the thumping of my own heart. All around me I could see the paths of the park branching out like the branches of its many trees.

A bush stood next to Mike.

You can also see Mike here.

>ask mike about torn paper
Mike turned to face me. 
Ask Mike for help distracting Rakesh? (yes/no)

>yes
"Hey Mike, I need some help from you. I think Rakesh, the guy who owns the Indian restaurant has something that I need."

"Indian restaurant? Oh yeah the one on Grove Street. Yeah, what do you need help with?"

"Can you keep the owner busy for a few minutes so I can get that paper?"

Mike thought for a bit, running his hands through his beard then saying, "I know one thing that might distract him, follow me." He started walking in the direction of the restaurant.

Front of Restaurant
I peered inside the window and saw an almost empty restaurant. It looked like the owner was just closing up for the night. I remembered Rakesh's, the food from there always reminded me of home, not just by its flavors, but by the heart that was put into its preparation. An old staple of New York, Rakesh's Indian Restaurant was to the west.

You can see Mike here.

Mike walked in, telling me to wait just around the corner. I peeked around, just managing to make out him walking up to Rakesh. I saw them exchanging some words. I couldn't exactly make out what they said, as the speech sonded muffled, like I was sitting inside a car watching the road go by. Both of them walked out, and I could finally hear what they were saying:
"No, not really. Ought is not a question of morality Rakesh. Here, let me give you an example, from the statement 'He is a captain' you can logically infer the conclusion that 'He ought to do whatever a captain ought to do'. That shows that an 'is' premise can entail an 'ought' conclusion."

"I still don't seem to understand."

"That's fine, I have some books in my study that I'll show you. You can borrow them and come right back to the restaurant."

I waited for a few seconds then saw Mike and Rakesh disappear around the corner.

>look
Front of Restaurant
I peered inside the window and saw an almost empty restaurant. It looked like the owner was just closing up for the night. I remembered Rakesh's, the food from there always reminded me of home, not just by its flavors, but by the heart that was put into its preparation. An old staple of New York, Rakesh's Indian Restaurant was to the west.

* * *

>e
Crimson Way
I stepped out into the street, and felt the crackling of the lamp above me, like a barber's clippers slowly clipping away my sanity. The idle droning of cars was only cut short by a horn once in a while, breaking the monotony. If I remembered correctly Steve's Fine Establishment was a short walk east of here. I had never really gone west of the alley, that area tended to be too filled with hoodlums to warrant a visit. Maybe I could find CG's killer there?

>n
Crime scene
As my eyes glanced over the scene I saw CG lying in front of me, and a dumpster to my north.

You can see CG here.

>s
Crimson Way
If I remembered correctly Steve's Fine Establishment was a short walk east of here. I had never really gone west of the alley, that area tended to be too filled with hoodlums to warrant a visit. Maybe I could find CG's killer there?

>e
Front of Steve's
Incandescent bulbs spilled their light over the entrance, bringing to attention the dilapidated and ignored posters on the glass wall. I could see that the inside was full of people, full of life, and the coldness of the outside hit me even harder. To the north of me stood Steve's Fine Establishment.

You can see Posters here.

>n
I stepped forward and a muscular gentleman held out his hand. He grunted in my direction, as if cueing me to say something.

Enter password:

>swordfish
The bouncer grunted approvingly.

* * *

>ne
You can't go that way.

>look
Front of Steve's
To the north of me stood Steve's Fine Establishment.

You can see Posters here.

* * *

>barpword
That's not a verb I recognise.

>look
Front of Steve's
To the north of me stood Steve's Fine Establishment.

You can see Posters here.

* * *

>look
Front of Steve's
To the north of me stood Steve's Fine Establishment.

You can see Posters here.

>look
Front of Steve's
To the north of me stood Steve's Fine Establishment.

You can see Posters here.

* * *

>e
Crimson Way
I stepped out into the street, and felt the crackling of the lamp above me, like a barber's clippers slowly clipping away my sanity. The idle droning of cars was only cut short by a horn once in a while, breaking the monotony. If I remembered correctly Steve's Fine Establishment was a short walk east of here. I had never really gone west of the alley, that area tended to be too filled with hoodlums to warrant a visit. Maybe I could find CG's killer there?

I beg your pardon?

>e
Front of Steve's
Incandescent bulbs spilled their light over the entrance, bringing to attention the dilapidated and ignored posters on the glass wall. I could see that the inside was full of people, full of life, and the coldness of the outside hit me even harder. To the north of me stood Steve's Fine Establishment.

You can see Door to Steve's and Posters here.

>w
Crimson Way
I stepped out into the street, and felt the crackling of the lamp above me, like a barber's clippers slowly clipping away my sanity. The idle droning of cars was only cut short by a horn once in a while, breaking the monotony. If I remembered correctly Steve's Fine Establishment was a short walk east of here. I had never really gone west of the alley, that area tended to be too filled with hoodlums to warrant a visit. Maybe I could find CG's killer there?

* * *

>s
Grove Street
Slowly walking down the street I could feel the rain falling down on me, like a comforting blanket telling me that this was all some kind of twisted nightmare. As I passed faceless sheltered souls I couldn't help but think about one of those passing me by. I trudged on, passing these thoughts by as mere flickers of a cruelly optimistic imagination, trying to play tricks on me and distract me from my goal. I looked around and saw an old favorite restaurant of mine to the west, an Indian place that served the best chaat in NYC.

>e
Apartments
The flickering of the lights was in tune with the multitude of flies buzzing around them. I looked up the stairs and saw door after door, mirrored into the distance. The color of the walls reflected lower middle class America, but were so worn out you couldn't even tell.

You can see Doorbell here.

I beg your pardon?

>x doorbell
I looked at the doorbell and saw the numbers 1 through 100, each with a name next to it as well as a button.

Which number apartment?

>36
Apartment 36, the name is scratched off...

Visit this apartment (yes/no)

>yes
There's no one here to talk to.

Visit this apartment (yes/no)

* * *

>x bush
A common bush. Upon examination I noticed that there was a sports coat discarded inside it. Whoever left it must've been in a hurry because they didn't even try to conceal it.

>wear coat
(first taking Sports coat)
You put on Sports coat.

>e
Crimson Way
I stepped out into the street, and felt the crackling of the lamp above me, like a barber's clippers slowly clipping away my sanity. The idle droning of cars was only cut short by a horn once in a while, breaking the monotony. If I remembered correctly Steve's Fine Establishment was a short walk east of here. I had never really gone west of the alley, that area tended to be too filled with hoodlums to warrant a visit. Maybe I could find CG's killer there?

* * *

>yes
I walked up to apartment 36
Knock sequence:

>three short knocks then two long knocks
I walked up to apartment 36 and knocked on the door. The peephole opened and I heard a voice that seemed like it had just swallowed a spoonful of cinnamon.

"Ah. Ya must be the guy Pro sent. Come on in."

The door opened and I looked inside to the musty room, half the wallpaper peeling off, and generic furniture giving it a fake lived-in feel. No sooner had I stepped in when the door shut behind me and Rakesh stepped out from the dark.

"Now, here's the thing."
His accent was as thick as his mustache.
"The things I hate the most are customers who dine and dash, and snoopers, and you just so happen to fall into the last category. Looks like me and my friend here are gonna need to have a bit of a chat with you."

Knock sequence:

* * *

>w
Central Park
A hangout for all kinds of colorful characters and clueless tourists. Trees obscured my view from every direction, and I saw the usual goons scattered about. It was eerily quiet out; the only thing I could hear ofher than the crickets and creatures was the thumping of my own heart. All around me I could see the paths of the park branching out like the branches of its many trees.

A bush stood next to Mike.

You can also see Mike here.

>wear coat
You can't see any such thing.

>x bush
A common bush. Upon examination I noticed that there was a sports coat discarded inside it. Whoever left it must've been in a hurry because they didn't even try to conceal it.

* * *

>tsratsr
That's not a verb I recognise.

>tsrtsr
That's not a verb I recognise.

>tsr
That's not a verb I recognise.

>tsr
That's not a verb I recognise.

>r
That's not a verb I recognise.

>sr
That's not a verb I recognise.

* * *

>s
Crimson Way
I stepped out into the street, and felt the crackling of the lamp above me, like a barber's clippers slowly clipping away my sanity. The idle droning of cars was only cut short by a horn once in a while, breaking the monotony. If I remembered correctly Steve's Fine Establishment was a short walk east of here. I had never really gone west of the alley, that area tended to be too filled with hoodlums to warrant a visit. Maybe I could find CG's killer there? I also remembered Grove Street to my south, which had Rakesh's Indian Restaurant as well as an apartment complex.

>ei
That's not a verb I recognise.

>e
Front of Steve's
Incandescent bulbs spilled their light over the entrance, bringing to attention the dilapidated and ignored posters on the glass wall. I could see that the inside was full of people, full of life, and the coldness of the outside hit me even harder. To the north of me stood Steve's Fine Establishment.

You can see Posters here.

>w
Crimson Way
If I remembered correctly Steve's Fine Establishment was a short walk east of here. I had never really gone west of the alley, that area tended to be too filled with hoodlums to warrant a visit. Maybe I could find CG's killer there?

>w
Central Park
A hangout for all kinds of colorful characters and clueless tourists. Trees obscured my view from every direction, and I saw the usual goons scattered about. It was eerily quiet out; the only thing I could hear ofher than the crickets and creatures was the thumping of my own heart. All around me I could see the paths of the park branching out like the branches of its many trees.

You can see Mike and Bush here.

>x bush
A common bush. Upon examination I noticed that there was a sports coat discarded inside it. Whoever left it must've been in a hurry because they didn't even try to conceal it.

>inv
You are carrying:
  Clues

>look
Central Park
 All around me I could see the paths of the park branching out like the branches of its many trees.

You can see Sports coat (in which is Notebook), Mike and Bush here.

* * *

>s
Crimson Way
I stepped out into the street, and felt the crackling of the lamp above me, like a barber's clippers slowly clipping away my sanity. The idle droning of cars was only cut short by a horn once in a while, breaking the monotony. If I remembered correctly Steve's Fine Establishment was a short walk east of here. I had never really gone west of the alley, that area tended to be too filled with hoodlums to warrant a visit. Maybe I could find CG's killer there? I also remembered Grove Street to my south, which had Rakesh's Indian Restaurant as well as an apartment complex.

>n
Crime scene
As my eyes glanced over the scene I saw CG lying in front of me, and a dumpster to my north.

You can see CG here.

>n
End of alley
As I walked towards the end of the alley the walls around me loomed with their neverending height. It stank of rotten food and cigarettes, which all seemed to emanate from the dumpster in front of me. A glint from the dumpster caught my eye.

A green dumpster sat still at the end of the alley.

>take knife
You can't see any such thing.

>open
(Clues)
That's not a command I recognize.

>open dumpster
You open Dumpster, revealing Knife.

>take knife
Looking through the dumpster I saw a knife tossed there, seemingly having fulfilled its purpose. Blood covered the blade and I shuddered thinking where it came from. I considered that it might draw suspicion on me if I were carrying around a bloody knife, but I picked it up. It might come in handy...

>inv
You are carrying:
  Knife
  Clues

>s
Crime scene
As my eyes glanced over the scene I saw CG lying in front of me, and a dumpster to my north.

You can see CG here.

* * *

>w
You can't go that way.

>e
You can't go that way.

>s
Crimson Way
If I remembered correctly Steve's Fine Establishment was a short walk east of here. I had never really gone west of the alley, that area tended to be too filled with hoodlums to warrant a visit. Maybe I could find CG's killer there?

* * *

>drop knife
That's not a command I recognize.

* * *

>n
Crime scene
As my eyes glanced over the scene I saw CG lying in front of me, and a dumpster to my north.

You can see CG here.

>x cg pocket
I looked in her pocket and saw the corner of a neatly creased piece of paper sticking out.

* * *

>s
Crimson Way
I stepped out into the street, and felt the crackling of the lamp above me, like a barber's clippers slowly clipping away my sanity. The idle droning of cars was only cut short by a horn once in a while, breaking the monotony. If I remembered correctly Steve's Fine Establishment was a short walk east of here. I had never really gone west of the alley, that area tended to be too filled with hoodlums to warrant a visit. Maybe I could find CG's killer there?

>e
Front of Steve's
Incandescent bulbs spilled their light over the entrance, bringing to attention the dilapidated and ignored posters on the glass wall. I could see that the inside was full of people, full of life, and the coldness of the outside hit me even harder. To the north of me stood Steve's Fine Establishment.

You can see Door to Steve's and Posters here.

* * *

>swordfish
The muscular gentleman grunted approvingly.

Steve's Fine Establishment
The comforting smell of flannel and fermented yeast smothered me when I walked in. I had heard about this place from a few of my friends, but had never actually visited it. Steve stood behind the table, tending to his customers. All around me people sat eating food and consuming fermented yeast in different flavors.

You can see Door to Steve's and Steve here.

>ask steve about cg
Steve looked up from his table
"Have you seen CG around recently?"

"No, I haven't... But you know how she was, you could blink twice and she'd be gone."

>ask steve about receipt
"Wait a second. I found this receipt with CG... The receipt is from your place which means CG was here."

"Uh... yes it seems she was. Why were you peeking around in her stuff?"

Press for more info? (yes/no)

>yes
That was a rhetorical question.

Press for more info? (yes/no)

>y
That was a rhetorical question.

Press for more info? (yes/no)

>y
That was a rhetorical question.

Press for more info? (yes/no)

>yes
That was a rhetorical question.

Press for more info? (yes/no)

>s
(first opening Door to Steve's)
Steve waved and went to another customer.

Front of Steve's
Incandescent bulbs spilled their light over the entrance, bringing to attention the dilapidated and ignored posters on the glass wall. I could see that the inside was full of people, full of life, and the coldness of the outside hit me even harder. To the north of me stood Steve's Fine Establishment.

You can see Door to Steve's and Posters here.

Press for more info? (yes/no)

>inv
You are carrying:
  Receipt from Steve's
  Clues

Press for more info? (yes/no)

>inv
You are carrying:
  Receipt from Steve's
  Clues

Press for more info? (yes/no)

* * *

>s
Crimson Way
I stepped out into the street, and felt the crackling of the lamp above me, like a barber's clippers slowly clipping away my sanity. The idle droning of cars was only cut short by a horn once in a while, breaking the monotony. If I remembered correctly Steve's Fine Establishment was a short walk east of here. I had never really gone west of the alley, that area tended to be too filled with hoodlums to warrant a visit. Maybe I could find CG's killer there? I also remembered Grove Street to my south, which had Rakesh's Indian Restaurant as well as an apartment complex.

>s
Grove Street
Slowly walking down the street I could feel the rain falling down on me, like a comforting blanket telling me that this was all some kind of twisted nightmare. As I passed faceless sheltered souls I couldn't help but think about one of those passing me by. I trudged on, passing these thoughts by as mere flickers of a cruelly optimistic imagination, trying to play tricks on me and distract me from my goal. I looked around and saw an old favorite restaurant of mine to the west, an Indian place that served the best chaat in NYC.

* * *

>w
Rakesh's Restaurant
The warm smell of fresh indian food hit my nose as soon as I waked in. I could see the store owner Rakesh behind his register, adding up the latest check.

You can see Rakesh and Register Drawer (closed) here.

>open drawer
You open Register Drawer.

>look
Rakesh's Restaurant
The warm smell of fresh indian food hit my nose as soon as I waked in. I could see the store owner Rakesh behind his register, adding up the latest check.

You can see Rakesh and Register Drawer (empty) here.

>close drawer
You close Register Drawer.

>open register drawer
Rakesh stood there behind the register, I couldn't get to the drawer.

>look
Rakesh's Restaurant
The warm smell of fresh indian food hit my nose as soon as I waked in. I could see the store owner Rakesh behind his register, adding up the latest check.

You can see Rakesh and Register Drawer (closed) here.

* * *

>w
Rakesh's Restaurant
The warm smell of fresh indian food hit my nose as soon as I waked in. I could see the store owner Rakesh behind his register, adding up the latest check.

You can see Rakesh and Register Drawer (closed) here.

>x drawer
You see nothing special about Register Drawer.

>open drawer
Rakesh stood there behind the register, I couldn't get to the drawer.

* * *

>w
Rakesh's Restaurant
The warm smell of fresh indian food hit my nose as soon as I waked in. I could see the store owner Rakesh behind his register, adding up the latest check.

You can see Rakesh and Register Drawer (closed) here.

>inv
You are carrying:
  Clues

>open drawer
Rakesh stood there behind the register, I couldn't get to the drawer.

>e
Front of Restaurant
I peered inside the window and saw an almost empty restaurant. It looked like the owner was just closing up for the night. I remembered Rakesh's, the food from there always reminded me of home, not just by its flavors, but by the heart that was put into its preparation. An old staple of New York, Rakesh's Indian Restaurant was to the west.

* * *

>n
Crimson Way
I stepped out into the street, and felt the crackling of the lamp above me, like a barber's clippers slowly clipping away my sanity. The idle droning of cars was only cut short by a horn once in a while, breaking the monotony. If I remembered correctly Steve's Fine Establishment was a short walk east of here. I had never really gone west of the alley, that area tended to be too filled with hoodlums to warrant a visit. Maybe I could find CG's killer there?

>w
Central Park
A hangout for all kinds of colorful characters and clueless tourists. Trees obscured my view from every direction, and I saw the usual goons scattered about. It was eerily quiet out; the only thing I could hear ofher than the crickets and creatures was the thumping of my own heart. All around me I could see the paths of the park branching out like the branches of its many trees.

Mike sat on a bench in front of me

A bush stood next to Mike.

>ask mike about torn paper
Mike turned to face me. 
There is no reply.

>ask mike about the torn paper
There is no reply.

>ask mike about the Torn Paper
There is no reply.

* * *

>s
You can't go that way.

>w
Front of Restaurant
I peered inside the window and saw an almost empty restaurant. It looked like the owner was just closing up for the night. I remembered Rakesh's, the food from there always reminded me of home, not just by its flavors, but by the heart that was put into its preparation. An old staple of New York, Rakesh's Indian Restaurant was to the west.

* * *

>w
Rakesh's Restaurant
The warm smell of fresh indian food hit my nose as soon as I waked in. I could see the store owner Rakesh behind his register, adding up the latest check.

You can see Rakesh and Register Drawer (closed) here.

>inv
I noticed a torn scrap of paper on the ground. As soon as I had noticed it, Rakesh picked it up and placed it in a drawer behind the cash register. If I wanted that note I would have to get him out of the restaurant first.

You are carrying:
  Clues

>inv
You are carrying:
  Clues

>e
Front of Restaurant
I peered inside the window and saw an almost empty restaurant. It looked like the owner was just closing up for the night. I remembered Rakesh's, the food from there always reminded me of home, not just by its flavors, but by the heart that was put into its preparation. An old staple of New York, Rakesh's Indian Restaurant was to the west.

* * *

>w
Central Park
A hangout for all kinds of colorful characters and clueless tourists. Trees obscured my view from every direction, and I saw the usual goons scattered about. It was eerily quiet out; the only thing I could hear ofher than the crickets and creatures was the thumping of my own heart. All around me I could see the paths of the park branching out like the branches of its many trees.

Mike sat on a bench in front of me

A bush stood next to Mike.

>ask mike about torn paper
Mike turned to face me. 
Ask Mike for help distracting Rakesh? (yes/no)

>yes
"Hey Mike, I need some help from you. I think Rakesh, the guy who owns the Indian restaurant has something that I need."

"Indian restaurant? Oh yeah the one on Grove Street. Yeah, what do you need help with?"

"Can you keep the owner busy for a few minutes so I can get that paper?"

Mike thought for a bit, running his hands through his beard then saying, "I know one thing that might distract him, follow me." He started walking in the direction of the restaurant.

Front of Restaurant
I peered inside the window and saw an almost empty restaurant. It looked like the owner was just closing up for the night. I remembered Rakesh's, the food from there always reminded me of home, not just by its flavors, but by the heart that was put into its preparation. An old staple of New York, Rakesh's Indian Restaurant was to the west.

Mike sat on a bench in front of me

Mike walked in, telling me to wait just around the corner. I peeked around, just managing to make out him walking up to Rakesh. I saw them exchanging some words. I couldn't exactly make out what they said, as the speech sonded muffled, like I was sitting inside a car watching the road go by. Both of them walked out, and I could finally hear what they were saying:
"No, not really. Ought is not a question of morality Rakesh. Here, let me give you an example, from the statement 'He is a captain' you can logically infer the conclusion that 'He ought to do whatever a captain ought to do'. That shows that an 'is' premise can entail an 'ought' conclusion."

"I still don't seem to understand."

"That's fine, I have some books in my study that I'll show you. You can borrow them and come right back to the restaurant."

I waited for a few seconds then saw Mike and Rakesh disappear around the corner.

Ask Mike for help distracting Rakesh? (yes/no)

* * *

>yes
There's no one here to talk to.

Visit this apartment (yes/no)

>no
There's no one here to talk to.

Visit this apartment (yes/no)

>look
Apartments
The flickering of the lights was in tune with the multitude of flies buzzing around them. I looked up the stairs and saw door after door, mirrored into the distance. The color of the walls reflected lower middle class America, but were so worn out you couldn't even tell.

You can see Doorbell here.

Visit this apartment (yes/no)

>x doorbell
I looked at the doorbell and saw the numbers 1 through 100, each with a name next to it as well as a button.

Which number apartment?

>5
Apartment 5, a Mr. H. Kojima
Visit this apartment? (yes/no)

>yes
I walked up to apartment 5 and knocked on the door. A young asian man sat on the ground, as if he was waiting for someone.

"Isaac...." He mumbled, "what took you so long?"

"Kept you waiting, huh."
It seemed this was the wrong apartment.

>x doorbell
I looked at the doorbell and saw the numbers 1 through 100, each with a name next to it as well as a button.

Which number apartment?

* * *

>36
Apartment 36, the name is scratched off...

Visit this apartment (yes/no)

>no
There's no one here to talk to.

Visit this apartment (yes/no)

>yes
There's no one here to talk to.

Visit this apartment (yes/no)

>yes
There's no one here to talk to.

Visit this apartment (yes/no)

>yse
That's not a verb I recognise.

Visit this apartment (yes/no)

* * *

>s
You can't go that way.

I beg your pardon?

>e
Apartments
The flickering of the lights was in tune with the multitude of flies buzzing around them. I looked up the stairs and saw door after door, mirrored into the distance. The color of the walls reflected lower middle class America, but were so worn out you couldn't even tell.

You can see Doorbell here.

* * *

>yes
I walked up to apartment 36
Knock sequence:

>x notepad
Silence. The door didn't even budge.

>inv
36 yee
You are carrying:
  Clues

>x doorbell
36 yee
I looked at the doorbell and saw the numbers 1 through 100, each with a name next to it as well as a button.

Which number apartment?

>367
Apartment 367. The nameplate is empty.

Which number apartment?

>36
Apartment 36, the name is scratched off...

Visit this apartment? (yes/no)

* * *

>three short knocks then two long knocks
I walked up to apartment 36 and knocked on the door. The peephole opened and I heard a voice that seemed like it had just swallowed a spoonful of cinnamon.

"'n who exactly 're ya? tony pro said da guy who was supposed ta meet me would be wearin' a sports coat.  Get outta 'ere before come out there."

>w
36 yee
Grove Street
Slowly walking down the street I could feel the rain falling down on me, like a comforting blanket telling me that this was all some kind of twisted nightmare. As I passed faceless sheltered souls I couldn't help but think about one of those passing me by. I trudged on, passing these thoughts by as mere flickers of a cruelly optimistic imagination, trying to play tricks on me and distract me from my goal. I looked around and saw an old favorite restaurant of mine to the west, an Indian place that served the best chaat in NYC.

>n
36 yee
Crimson Way
I stepped out into the street, and felt the crackling of the lamp above me, like a barber's clippers slowly clipping away my sanity. The idle droning of cars was only cut short by a horn once in a while, breaking the monotony. If I remembered correctly Steve's Fine Establishment was a short walk east of here. I had never really gone west of the alley, that area tended to be too filled with hoodlums to warrant a visit. Maybe I could find CG's killer there?

>w
36 yee
Central Park
A hangout for all kinds of colorful characters and clueless tourists. Trees obscured my view from every direction, and I saw the usual goons scattered about. It was eerily quiet out; the only thing I could hear ofher than the crickets and creatures was the thumping of my own heart. All around me I could see the paths of the park branching out like the branches of its many trees.

A bush stood next to Mike.

You can also see Mike here.

>x bush
36 yee
A common bush. Upon examination I noticed that there was a sports coat discarded inside it. Whoever left it must've been in a hurry because they didn't even try to conceal it.

>take coat
36 yee
Taken.

>wear coat
36 yee
You put on Sports coat.

>e
36 yee
Crimson Way
I stepped out into the street, and felt the crackling of the lamp above me, like a barber's clippers slowly clipping away my sanity. The idle droning of cars was only cut short by a horn once in a while, breaking the monotony. If I remembered correctly Steve's Fine Establishment was a short walk east of here. I had never really gone west of the alley, that area tended to be too filled with hoodlums to warrant a visit. Maybe I could find CG's killer there?

>s
36 yee
Grove Street
Slowly walking down the street I could feel the rain falling down on me, like a comforting blanket telling me that this was all some kind of twisted nightmare. As I passed faceless sheltered souls I couldn't help but think about one of those passing me by. I trudged on, passing these thoughts by as mere flickers of a cruelly optimistic imagination, trying to play tricks on me and distract me from my goal. I looked around and saw an old favorite restaurant of mine to the west, an Indian place that served the best chaat in NYC.

>e
36 yee
Apartments
The flickering of the lights was in tune with the multitude of flies buzzing around them. I looked up the stairs and saw door after door, mirrored into the distance. The color of the walls reflected lower middle class America, but were so worn out you couldn't even tell.

You can see Doorbell here.

>x doorbell
36 yee
I looked at the doorbell and saw the numbers 1 through 100, each with a name next to it as well as a button.

Which number apartment?

>36
Apartment 36, the name is scratched off...

Visit this apartment? (yes/no)

* * *

>yes
I walked up to apartment 36
Knock sequence:

>three short knocks then two long knocks
I walked up to apartment 36 and knocked on the door. The peephole opened and I heard a voice that seemed like it had just swallowed a spoonful of cinnamon.

"Ah. Ya must be the guy Pro sent. Come on in."

The door opened and I looked inside to the musty room, half the wallpaper peeling off, and generic furniture giving it a fake lived-in feel. No sooner had I stepped in when the door shut behind me and Rakesh stepped out from the dark.

"Now, here's the thing."
His accent was as thick as his mustache.
"The things I hate the most are customers who dine and dash, and snoopers, and you just so happen to fall into the last category. Looks like me and my friend here are gonna need to have a bit of a chat with you."

That's not a verb I recognise.

Knock sequence:

>bruh
Silence. The door didn't even budge.

* * *

>s
Grove Street
Slowly walking down the street I could feel the rain falling down on me, like a comforting blanket telling me that this was all some kind of twisted nightmare. As I passed faceless sheltered souls I couldn't help but think about one of those passing me by. I trudged on, passing these thoughts by as mere flickers of a cruelly optimistic imagination, trying to play tricks on me and distract me from my goal. I looked around and saw an old favorite restaurant of mine to the west, an Indian place that served the best chaat in NYC.

>inv
You are carrying:
  Clues

>x clues
I looked in my notebook and saw a list of clues that I had found so far.

>n
Crimson Way
I stepped out into the street, and felt the crackling of the lamp above me, like a barber's clippers slowly clipping away my sanity. The idle droning of cars was only cut short by a horn once in a while, breaking the monotony. If I remembered correctly Steve's Fine Establishment was a short walk east of here. I had never really gone west of the alley, that area tended to be too filled with hoodlums to warrant a visit. Maybe I could find CG's killer there? I also remembered Grove Street to my south, which had Rakesh's Indian Restaurant as well as an apartment complex.

>x cg
You can't see any such thing.

>n
Crime scene
As my eyes glanced over the scene I saw CG lying in front of me, and a dumpster to my north.

You can see CG here.

>x cg
I got down and looked at CG, trying to find anything that might lead me to find her murderer. A thick pool of blood spilled out from her head, giving her a devilish halo. I thought it would be best to check her arms, and her coat pocket.

>inv
You are carrying:
  Clues
    CG's body

>x cg's body
CG was lying dead in the alley when I saw her. I had no idea what had happened or who had done this to her.

>s
Crimson Way
I stepped out into the street, and felt the crackling of the lamp above me, like a barber's clippers slowly clipping away my sanity. The idle droning of cars was only cut short by a horn once in a while, breaking the monotony. If I remembered correctly Steve's Fine Establishment was a short walk east of here. I had never really gone west of the alley, that area tended to be too filled with hoodlums to warrant a visit. Maybe I could find CG's killer there? I also remembered Grove Street to my south, which had Rakesh's Indian Restaurant as well as an apartment complex.

I beg your pardon?

>s
Grove Street
Slowly walking down the street I could feel the rain falling down on me, like a comforting blanket telling me that this was all some kind of twisted nightmare. As I passed faceless sheltered souls I couldn't help but think about one of those passing me by. I trudged on, passing these thoughts by as mere flickers of a cruelly optimistic imagination, trying to play tricks on me and distract me from my goal. I looked around and saw an old favorite restaurant of mine to the west, an Indian place that served the best chaat in NYC.

* * *

>w
Central Park
A hangout for all kinds of colorful characters and clueless tourists. Trees obscured my view from every direction, and I saw the usual goons scattered about. It was eerily quiet out; the only thing I could hear ofher than the crickets and creatures was the thumping of my own heart. All around me I could see the paths of the park branching out like the branches of its many trees.

A bush stood next to Mike.

You can also see Mike here.

>e
Crimson Way
I stepped out into the street, and felt the crackling of the lamp above me, like a barber's clippers slowly clipping away my sanity. The idle droning of cars was only cut short by a horn once in a while, breaking the monotony. If I remembered correctly Steve's Fine Establishment was a short walk east of here. I had never really gone west of the alley, that area tended to be too filled with hoodlums to warrant a visit. Maybe I could find CG's killer there? I also remembered Grove Street to my south, which had Rakesh's Indian Restaurant as well as an apartment complex.

* * *

>w
Front of Restaurant
I peered inside the window and saw an almost empty restaurant. It looked like the owner was just closing up for the night. I remembered Rakesh's, the food from there always reminded me of home, not just by its flavors, but by the heart that was put into its preparation. An old staple of New York, Rakesh's Indian Restaurant was to the west.

I beg your pardon?

>w
Rakesh's Restaurant
The warm smell of fresh indian food hit my nose as soon as I waked in. I could see the store owner Rakesh behind his register, adding up the latest check.

You can see Rakesh and Register Drawer (closed) here.

>look
I noticed a torn scrap of paper on the ground. As soon as I had noticed it, Rakesh picked it up and placed it in a drawer behind the cash register. If I wanted that note I would have to get him out of the restaurant first.

Rakesh's Restaurant
The warm smell of fresh indian food hit my nose as soon as I waked in. I could see the store owner Rakesh behind his register, adding up the latest check.

You can see Rakesh and Register Drawer (closed) here.

>x register drawer
You see nothing special about Register Drawer.

>e
Front of Restaurant
I peered inside the window and saw an almost empty restaurant. It looked like the owner was just closing up for the night. I remembered Rakesh's, the food from there always reminded me of home, not just by its flavors, but by the heart that was put into its preparation. An old staple of New York, Rakesh's Indian Restaurant was to the west.

* * *

>n
You can't go that way.

>look
Front of Restaurant
I peered inside the window and saw an almost empty restaurant. It looked like the owner was just closing up for the night. I remembered Rakesh's, the food from there always reminded me of home, not just by its flavors, but by the heart that was put into its preparation. An old staple of New York, Rakesh's Indian Restaurant was to the west.

>e
Grove Street
Slowly walking down the street I could feel the rain falling down on me, like a comforting blanket telling me that this was all some kind of twisted nightmare. As I passed faceless sheltered souls I couldn't help but think about one of those passing me by. I trudged on, passing these thoughts by as mere flickers of a cruelly optimistic imagination, trying to play tricks on me and distract me from my goal. I looked around and saw an old favorite restaurant of mine to the west, an Indian place that served the best chaat in NYC.

* * *

>e
Grove Street
Slowly walking down the street I could feel the rain falling down on me, like a comforting blanket telling me that this was all some kind of twisted nightmare. As I passed faceless sheltered souls I couldn't help but think about one of those passing me by. I trudged on, passing these thoughts by as mere flickers of a cruelly optimistic imagination, trying to play tricks on me and distract me from my goal. I looked around and saw an old favorite restaurant of mine to the west, an Indian place that served the best chaat in NYC.

* * *

>w
Front of Restaurant
I peered inside the window and saw an almost empty restaurant. It looked like the owner was just closing up for the night. I remembered Rakesh's, the food from there always reminded me of home, not just by its flavors, but by the heart that was put into its preparation. An old staple of New York, Rakesh's Indian Restaurant was to the west.

>w
Rakesh's Restaurant
The warm smell of fresh indian food hit my nose as soon as I waked in. 

You can see Register Drawer (closed) here.

>look
I looked around and noticed a small key on the register desk. Maybe Rakesh had left it behind?

Rakesh's Restaurant
The warm smell of fresh indian food hit my nose as soon as I waked in. 

You can see Register Key and Register Drawer (closed) here.

>x register key
You see nothing special about Register Key.

>take it
Taken.

>inv
You are carrying:
  Register Key
  Clues
    Paper from Rakesh's
    CG's body

>use key on register
That's not a verb I recognise.

>use register key on register
That's not a verb I recognise.

>unlock register
What do you want to unlock Register Key with?

>register
I didn't understand that sentence.

>unlock register with register key
(Register Key with Register Key)
That doesn't seem to be something you can unlock.

>look
Rakesh's Restaurant
The warm smell of fresh indian food hit my nose as soon as I waked in. 

You can see Register Drawer (closed) here.

>unlock register drawer
What do you want to unlock Register Drawer with?

>key
You unlock Register Drawer.

>look
Rakesh's Restaurant
The warm smell of fresh indian food hit my nose as soon as I waked in. 

You can see Register Drawer (closed) here.

>open drawer
You open Register Drawer, revealing Money and Torn paper.

>take money
Hmm, I didn't want to commit petty theft. That would make me no better than the criminals I was hunting down.

>take paper
Which do you mean, Torn paper or Paper from Rakesh's?

* * *

>take torn paper
You can't see any such thing.

>inv
You are carrying:
  Register Key
  Clues
    Paper from Rakesh's
    CG's body

>look
Rakesh's Restaurant
The warm smell of fresh indian food hit my nose as soon as I waked in. 

You can see Register Drawer (in which is Money) here.

* * *

I beg your pardon?

>s
Grove Street
Slowly walking down the street I could feel the rain falling down on me, like a comforting blanket telling me that this was all some kind of twisted nightmare. As I passed faceless sheltered souls I couldn't help but think about one of those passing me by. I trudged on, passing these thoughts by as mere flickers of a cruelly optimistic imagination, trying to play tricks on me and distract me from my goal. I looked around and saw an old favorite restaurant of mine to the west, an Indian place that served the best chaat.

* * *

>x doorbell
I looked at the doorbell and saw the numbers 1 through 100, each with a name next to it as well as a button.

Which number apartment?

>4738247
Apartment 4738247. The nameplate is empty.

Which number apartment?

>111111
Apartment 111111. The nameplate is empty.

Which number apartment?

>388281
Apartment 388281. The nameplate is empty.

Which number apartment?

>324
Apartment 324. The nameplate is empty.

Which number apartment?

>123
Apartment 123. The nameplate is empty.

Which number apartment?

>123
Apartment 123. The nameplate is empty.

Which number apartment?

>152
Apartment 152. The nameplate is empty.

Which number apartment?

>81
Apartment 81, a Mr. A. MacIntyreApartment 81. The nameplate is empty.

Visit this apartment? (yes/no)

>yes
I walked up to apartment 81 and knocked on the door.

There's no one here to talk to.

Visit this apartment? (yes/no)

* * *

>x doorbell
I looked at the doorbell and saw the numbers 1 through 100, each with a name next to it as well as a button.

Which number apartment?

>81
Apartment 81, a Mr. A. MacIntyre
Visit this apartment? (yes/no)

>yes
I walked up to apartment 81 and knocked on the door. An old man in a suit opened the door, looking me up and down.
"Excuse me, do I know you?"

"Sorry about that, I seem to have gotten the wrong apartment. Good evening."

* * *

>e
Apartments
The flickering of the lights was in tune with the multitude of flies buzzing around them. I looked up the stairs and saw door after door, mirrored into the distance. The color of the walls reflected lower middle class America, but were so worn out you couldn't even tell.

You can see Doorbell here.

>x bell
You can't see any such thing.

* * *

>...
That's not a verb I recognise.

>help
That's not a verb I recognise.

>tsts
That's not a verb I recognise.

>tsts
That's not a verb I recognise.

>s
You can't go that way.

>ts
That's not a verb I recognise.

>t
What do you want to t?

>t
What do you want to t?

* * *

>s
Crimson Way
I stepped out into the street, and felt the crackling of the lamp above me, like a barber's clippers slowly clipping away my sanity. The idle droning of cars was only cut short by a horn once in a while, breaking the monotony. If I remembered correctly Steve's Fine Establishment was a short walk east of here. I had never really gone west of the alley, that area tended to be too filled with hoodlums to warrant a visit. Maybe I could find CG's killer there? I also remembered Grove Street to my south, which had Rakesh's Indian Restaurant as well as an apartment complex.

>w\
That's not a verb I recognise.

>s
Grove Street
Slowly walking down the street I could feel the rain falling down on me, like a comforting blanket telling me that this was all some kind of twisted nightmare. As I passed faceless sheltered souls I couldn't help but think about one of those passing me by. I trudged on, passing these thoughts by as mere flickers of a cruelly optimistic imagination, trying to play tricks on me and distract me from my goal. I looked around and saw an old favorite restaurant of mine to the west, an Indian place that served the best chaat.

* * *

>yes
I walked up to apartment 5 and knocked on the door. A young asian man sat on the ground, as if he was waiting for someone.

"Isaac...." He mumbled, "what took you so long?"

"Kept you waiting, huh."
It seemed this was the wrong apartment.

>look
Apartments
The flickering of the lights was in tune with the multitude of flies buzzing around them. I looked up the stairs and saw door after door, mirrored into the distance. The color of the walls reflected lower middle class America, but were so worn out you couldn't even tell.

You can see Doorbell here.

>x doorbell
I looked at the doorbell and saw the numbers 1 through 100, each with a name next to it as well as a button.

Which number apartment?

>18
Apartment 18, a Mr. T. Hundley
Visit this apartment? (yes/no)

>yes
I walked up to apartment 18 and knocked on the door, which swung open as soon as I knocked. A middle aged man with glasses sat on a sofa. In front of him were model submarines all placed in a diorama. Suddenly one of the submarines launched what looked like a miniature missile at another one. He turned quickly to look at me and I backed away, closing the door on my way out.

>x doorbell
I looked at the doorbell and saw the numbers 1 through 100, each with a name next to it as well as a button.

Which number apartment?

>15
Apartment 15, a Mr. S. Starr
Visit this apartment? (yes/no)

>yes
I walked up to apartment 15 and knocked on the door. A young man opened it, and as soon as I stepped in, the freezing cold hit me as if I had eaten an ice cube. I looked around but couldn't see anything due to the soot covering the lights. I quickly waved goodbye to Mr. Starr and stepped out of the apartment.

>x doorbell
I looked at the doorbell and saw the numbers 1 through 100, each with a name next to it as well as a button.

Which number apartment?

>4
Apartment 4, a Mr. J. Hillman
Visit this apartment? (yes/no)

>yes
I walked up to apartment 4 and knocked on the door. I had just stepped back when the door slammed open and an old white man in glasses pointed a weapon of mass destruction at me.

"War is inevitable. Humans will always create a new enemy to declare war on, the only alternative is to love war. Only after loving war can we deconstruct our motivations in it."
I slammed the door shut and bolted back down the stairs, my shoes echoing off each stair.

* * *

>s
Crimson Way
I stepped out into the street, and felt the crackling of the lamp above me, like a barber's clippers slowly clipping away my sanity. The idle droning of cars was only cut short by a horn once in a while, breaking the monotony. If I remembered correctly Steve's Fine Establishment was a short walk east of here. I had never really gone west of the alley, that area tended to be too filled with hoodlums to warrant a visit. Maybe I could find CG's killer there? I also remembered Grove Street to my south, which had Rakesh's Indian Restaurant as well as an apartment complex.

>look
Crimson Way
I stepped out into the street, and felt the crackling of the lamp above me, like a barber's clippers slowly clipping away my sanity. The idle droning of cars was only cut short by a horn once in a while, breaking the monotony. If I remembered correctly Steve's Fine Establishment was a short walk east of here. I had never really gone west of the alley, that area tended to be too filled with hoodlums to warrant a visit. Maybe I could find CG's killer there?

>w
Central Park
A hangout for all kinds of colorful characters and clueless tourists. Trees obscured my view from every direction, and I saw the usual goons scattered about. It was eerily quiet out; the only thing I could hear ofher than the crickets and creatures was the thumping of my own heart. All around me I could see the paths of the park branching out like the branches of its many trees.

A bush stood next to Mike.

You can also see Mike here.

* * *

>x cg
I got down and looked at CG, trying to find anything that might lead me to find her murderer. A thick pool of blood spilled out from her head, giving her a devilish halo. I thought it would be best to check her arms, and her coat pocket.

>s
Crimson Way
I stepped out into the street, and felt the crackling of the lamp above me, like a barber's clippers slowly clipping away my sanity. The idle droning of cars was only cut short by a horn once in a while, breaking the monotony. If I remembered correctly Jimmy's Bar was a short walk east of here. I had never really gone west of the alley, that area tended to be too filled with hoodlums to warrant a visit. Maybe I could find CG's killer there?

* * *

>n
Jimmys Bar
The comforting smell of fermented yeast and formaldehyde smothered me when I walked in. I knew the owner Jimmy personally, he was an old friend of mine, but as of recent times I hadn't been keeping up with him as much as I wished to. It had been a few months since I'd last seen him.

You can see Jimmy here.

>say hi to jimmy
"Hey Jimmy, how've you been?

"Not too bad."

>tell jimmy about cg
There is no reply.

>ask jimmy about cg
"Have you seen CG around recently?"

"No, I haven't... But you know how she was, you could blink twice and she'd be gone."

* * *

>n
Jimmys Bar
The comforting smell of fermented yeast and formaldehyde smothered me when I walked in. I knew the owner Jimmy personally, he was an old friend of mine, but as of recent times I hadn't been keeping up with him as much as I wished to. It had been a few months since I'd last seen him.

You can see Jimmy here.

>tell jimmy about cg
Jimmy looked up from his bar
"Actually uh, Jimmy there's something I wanted to tell you."
The words stuck in my mouth like taffy on a hot Summer's day. It was as if by not saying them I could change what had already happened.

* * *

>x cg
I got down and looked at CG, trying to find anything that might lead me to find her murderer. A thick pool of blood spilled out from her head, giving her a devilish halo. I thought it would be best to check her arms, and her coat pocket.

>x cg arms
I only understood you as far as wanting to examine CG.

>x cg arm
I only understood you as far as wanting to examine CG.

>x arm
Which do you mean, CG's left arm or CG's right arm?

>left
I turned over her left arm, and I saw gashes all the way down it. Each gash I saw felt like a stab through my own heart.

>x arm
Which do you mean, CG's left arm or CG's right arm?

>right
I held her right arm up to the lamplight, and in the yellow glow I saw a watch tan, but no watch. Had it been stolen?

>inv
You are carrying:
  Clues
    CG's body

>inv
You are carrying:
  Clues
    CG's body

>s
Crimson Way
I stepped out into the street, and felt the crackling of the lamp above me, like a barber's clippers slowly clipping away my sanity. The idle droning of cars was only cut short by a horn once in a while, breaking the monotony. If I remembered correctly Jimmy's Bar was a short walk east of here. I had never really gone west of the alley, that area tended to be too filled with hoodlums to warrant a visit. Maybe I could find CG's killer there?

>inc
That's not a verb I recognise.

>inv
You are carrying:
  Clues
    CG's body

>examine cg's body
CG was lying dead in the alley when I saw her. Her watch was missing and there were cuts all the way down her arm.

>open clues
That's not a command I recognize.

* * *

>x cg
I got down and looked at CG, trying to find anything that might lead me to find her murderer. A thick pool of blood spilled out from her head, giving her a devilish halo. I thought it would be best to check her arms, and her coat pocket.

>x arm
Which do you mean, CG's left arm or CG's right arm?

* * *

>left
I turned over her left arm, and I saw gashes all the way down it. Each gash I saw felt like a stab through my own heart.

>x right arm
I held her right arm up to the lamplight, and in the yellow glow I saw a watch tan, but no watch. Had it been stolen?

>s
Crimson Way
I stepped out into the street, and felt the crackling of the lamp above me, like a barber's clippers slowly clipping away my sanity. The idle droning of cars was only cut short by a horn once in a while, breaking the monotony. If I remembered correctly Jimmy's Bar was a short walk east of here. I had never really gone west of the alley, that area tended to be too filled with hoodlums to warrant a visit. Maybe I could find CG's killer there?

>inv
You are carrying:
  Clues
    CG's watch
    CG's body

>x cg's watch
CG's watch. If I remembered correctly it was a family heirloom that her Grandma took with her when she immigrated.

* * *

>x cg
I got down and looked at CG, trying to find anything that might lead me to find her murderer. A thick pool of blood spilled out from her head, giving her a devilish halo. I thought it would be best to check her arms, and her coat pocket.

>x coat pocket
I looked in her pocket and saw the corner of a neatly creased piece of paper sticking out.

>inv
You are carrying:
  Clues
    CG's body

>take paper
I unfolded the paper and saw a receipt from Steve's Fine Establishment. I knew where that was, I had been there a couple of times. It wasn't a place you'd go with your friends, but it was still a nice place. The owner wasn't too bad either, something I couldn't say about half the places I knew.

>inv
You are carrying:
  Receipt from Steve's
  Clues
    CG's body

>inv
You are carrying:
  Receipt from Steve's
  Clues
    CG's body

>s
Crimson Way
I stepped out into the street, and felt the crackling of the lamp above me, like a barber's clippers slowly clipping away my sanity. The idle droning of cars was only cut short by a horn once in a while, breaking the monotony. If I remembered correctly Steve's Fine Establishment was a short walk east of here. I had never really gone west of the alley, that area tended to be too filled with hoodlums to warrant a visit. Maybe I could find CG's killer there?

>e
Front of Steve's
Incandescent bulbs spilled their light over the entrance, bringing to attention the dilapidated and ignored posters on the glass wall. I could see that the inside was full of people, full of life, and the coldness of the outside hit me even harder. To the north of me stood Steve's Fine Establishment.

You can see Posters here.

* * *

>n
I stepped forward and a muscular gentleman held out his hand. He grunted in my direction, as if cueing me to say something.

Enter password:

>swordfish
The muscular gentleman grunted approvingly.

Steve's Fine Establishment
The comforting smell of flannel and fermented yeast smothered me when I walked in. I had heard about this place from a few of my friends, but had never actually visited it. Steve stood behind the table, tending to his customers. All around me people sat eating food and consuming fermented yeast in different flavors.

You can see Steve here.

>ask steve about cg
Steve looked up from his table
"Have you seen CG around recently?"

"No, I haven't... But you know how she was, you could blink twice and she'd be gone."

>ask steve about receipt
"Wait a second. I found this receipt with CG... The receipt is from you. CG was here."

"Uh... yes it seems she was. Why were you peeking around in her stuff?"

Press for more info? (y/n)

>yes
"Don't change the topic. Why was CG here?"

"Look I don't really know. She came here, stayed for a bit... Wait. There was one thing that was kind of suspicious, as soon as she saw a man running past she quickly left and went the other way. I don't know what that was all about, but it seemed like she knew him. While she was leaving, she dropped this piece of paper, I couldn't give it back to her."
Steve hands you CG's Note
That was a rhetorical question.

Press for more info? (y/n)

>inv
You are carrying:
  Receipt from Steve's
  Clues
    CG's body

Press for more info? (y/n)

* * *

>x cg
I got down and looked at CG, trying to find anything that might lead me to find her murderer. A thick pool of blood spilled out from her head, giving her a devilish halo. I thought it would be best to check her arms, and her coat pocket.

>take note
You can't see any such thing.

>x cg pocket
I looked in her pocket and saw the corner of a neatly creased piece of paper sticking out.

* * *

>take paper
I unfolded the paper and saw a receipt from Steve's Fine Establishment. I knew where that was, I had been there a couple of times. It wasn't a place you'd go with your friends, but it was still a nice place. The owner wasn't too bad either, something I couldn't say about half the places I knew.

>look
Crime scene
As my eyes glanced over the scene I saw CG lying in front of me, and a dumpster to my north.

You can see CG here.

>inv
You are carrying:
  Receipt from Steve's
  Clues
    CG's body

>s
Crimson Way
I stepped out into the street, and felt the crackling of the lamp above me, like a barber's clippers slowly clipping away my sanity. The idle droning of cars was only cut short by a horn once in a while, breaking the monotony. If I remembered correctly Steve's Fine Establishment was a short walk east of here. I had never really gone west of the alley, that area tended to be too filled with hoodlums to warrant a visit. Maybe I could find CG's killer there? I also remembered Grove Street to my south, which had Rakesh's Indian Restaurant as well as an apartment complex.

* * *

>e
Crimson Way
I stepped out into the street, and felt the crackling of the lamp above me, like a barber's clippers slowly clipping away my sanity. The idle droning of cars was only cut short by a horn once in a while, breaking the monotony. If I remembered correctly Steve's Fine Establishment was a short walk east of here. I had never really gone west of the alley, that area tended to be too filled with hoodlums to warrant a visit. Maybe I could find CG's killer there? I also remembered Grove Street to my south, which had Rakesh's Indian Restaurant as well as an apartment complex.

>e
Front of Steve's
Incandescent bulbs spilled their light over the entrance, bringing to attention the dilapidated and ignored posters on the glass wall. I could see that the inside was full of people, full of life, and the coldness of the outside hit me even harder. To the north of me stood Steve's Fine Establishment.

You can see Door to Steve's and Posters here.

* * *

>swordfish
The muscular gentleman grunted approvingly.

Steve's Fine Establishment
The comforting smell of flannel and fermented yeast smothered me when I walked in. I had heard about this place from a few of my friends, but had never actually visited it. Steve stood behind the table, tending to his customers. All around me people sat eating food and consuming fermented yeast in different flavors.

You can see Door to Steve's and Steve here.

>n
You can't go that way.

>ask steve about cg
Steve looked up from his table
"Have you seen CG around recently?"

"No, I haven't... But you know how she was, you could blink twice and she'd be gone."

>atsk steve about receipt
That's not a verb I recognise.

>ask steve about receipt
"Wait a second. I found this receipt with CG... The receipt is from your place which means CG was here."

"Uh... yes it seems she was. Why were you peeking around in her stuff?"

Press for more info? (yes/no)

* * *

>n
(first opening Door to Steve's)
It seems to be locked.

>n
(first opening Door to Steve's)
It seems to be locked.

>look
Front of Steve's
Incandescent bulbs spilled their light over the entrance, bringing to attention the dilapidated and ignored posters on the glass wall. I could see that the inside was full of people, full of life, and the coldness of the outside hit me even harder. To the north of me stood Steve's Fine Establishment.

You can see Door to Steve's and Posters here.

>open door to steve's
It seems to be locked.

>inv
You are carrying:
  CG's Note (Torn)
  Receipt from Steve's
  Clues
    CG's body

>w
Crimson Way
I stepped out into the street, and felt the crackling of the lamp above me, like a barber's clippers slowly clipping away my sanity. The idle droning of cars was only cut short by a horn once in a while, breaking the monotony. If I remembered correctly Steve's Fine Establishment was a short walk east of here. I had never really gone west of the alley, that area tended to be too filled with hoodlums to warrant a visit. Maybe I could find CG's killer there? I also remembered Grove Street to my south, which had Rakesh's Indian Restaurant as well as an apartment complex.

* * *

>w
You can't go that way.

>ask mike about torn paper
Mike turned to face me. 
There is no reply.

>e
Mike sat back down on his bench.

Crimson Way
I stepped out into the street, and felt the crackling of the lamp above me, like a barber's clippers slowly clipping away my sanity. The idle droning of cars was only cut short by a horn once in a while, breaking the monotony. If I remembered correctly Steve's Fine Establishment was a short walk east of here. I had never really gone west of the alley, that area tended to be too filled with hoodlums to warrant a visit. Maybe I could find CG's killer there? I also remembered Grove Street to my south, which had Rakesh's Indian Restaurant as well as an apartment complex.

>s
Grove Street
Slowly walking down the street I could feel the rain falling down on me, like a comforting blanket telling me that this was all some kind of twisted nightmare. As I passed faceless sheltered souls I couldn't help but think about one of those passing me by. I trudged on, passing these thoughts by as mere flickers of a cruelly optimistic imagination, trying to play tricks on me and distract me from my goal. I looked around and saw an old favorite restaurant of mine to the west, an Indian place that served the best chaat in NYC.

* * *

>w
Rakesh's Restaurant
The warm smell of fresh indian food hit my nose as soon as I waked in. I could see the store owner Rakesh behind his register, adding up the latest check.

You can see Rakesh and Register Drawer (closed) here.

>look
I noticed a torn scrap of paper on the ground it was torn in a pattern identical to CG's Note. As soon as I had noticed it, Rakesh picked it up and placed it in a drawer behind the cash register. If I wanted that note I would have to get him out of the restaurant first.

Rakesh's Restaurant
The warm smell of fresh indian food hit my nose as soon as I waked in. I could see the store owner Rakesh behind his register, adding up the latest check.

You can see Rakesh and Register Drawer (closed) here.

>e
Front of Restaurant
I peered inside the window and saw an almost empty restaurant. It looked like the owner was just closing up for the night. I remembered Rakesh's, the food from there always reminded me of home, not just by its flavors, but by the heart that was put into its preparation. An old staple of New York, Rakesh's Indian Restaurant was to the west.

* * *

>look
I looked around and noticed a small key on the register desk. Maybe Rakesh had left it behind?

Rakesh's Restaurant
The warm smell of fresh indian food hit my nose as soon as I waked in. 

You can see Register Key and Register Drawer (closed) here.

>take register key
Taken.

>inv
You are carrying:
  Register Key
  CG's Note (Torn)
  Receipt from Steve's
  Clues
    Paper from Rakesh's
    CG's body

>x cg's note
A note written distinctly in CG's handwriting. It reads "East from Grove Street
Knocks: three short knocks then two long knocks
Apartm-"
The note cuts off, the tear seems too precise to be an accident.

>use register key on register drawer
That's not a verb I recognise.

>look
Rakesh's Restaurant
The warm smell of fresh indian food hit my nose as soon as I waked in. 

You can see Register Drawer (closed) here.

>inv
You are carrying:
  Register Key
  CG's Note (Torn)
  Receipt from Steve's
  Clues
    Paper from Rakesh's
    CG's body

>unlock register drawer
What do you want to unlock Register Drawer with?

>register key
You unlock Register Drawer.

>look
Rakesh's Restaurant
The warm smell of fresh indian food hit my nose as soon as I waked in. 

You can see Register Drawer (closed) here.

* * *

>take money
Hmm, I didn't want to commit petty theft. That would make me no better than the criminals I was hunting down.

>take torn paper
Taken.

I noticed this torn scrap fit perfectly with the half of CG's note. I combined the two together to read "East from Grove Street
Knocks: three short knocks then two long knocks
Apartment 36"

>inv
You are carrying:
  Register Key
  CG's Note (Torn)
  Receipt from Steve's
  Clues
    Paper from Rakesh's
    CG's body

* * *

>x cg's note
A note written distinctly in CG's handwriting. It reads "East from Grove Street
Knocks: three short knocks then two long knocks
Apartm-"
The note cuts off, the tear seems too precise to be an accident.

>inv
You are carrying:
  Register Key
  CG's Note (Torn)
  Receipt from Steve's
  Clues
    Paper from Rakesh's
    CG's body

* * *

>x cg
I got down and looked at CG, trying to find anything that might lead me to find her murderer. A thick pool of blood spilled out from her head, giving her a devilish halo. I thought it would be best to check her arms, and her coat pocket.

>x cg pocket
I looked in her pocket and saw the corner of a neatly creased piece of paper sticking out.

* * *

>take paper
I unfolded the paper and saw a receipt from Steve's Fine Establishment. I knew where that was, I had been there a couple of times. It wasn't a place you'd go with your friends, but it was still a nice place. The owner wasn't too bad either, something I couldn't say about half the places I knew.

>s
Crimson Way
I stepped out into the street, and felt the crackling of the lamp above me, like a barber's clippers slowly clipping away my sanity. The idle droning of cars was only cut short by a horn once in a while, breaking the monotony. If I remembered correctly Steve's Fine Establishment was a short walk east of here. I had never really gone west of the alley, that area tended to be too filled with hoodlums to warrant a visit. Maybe I could find CG's killer there? I also remembered Grove Street to my south, which had Rakesh's Indian Restaurant as well as an apartment complex.

* * *

>ask steve about receipt
Steve looked up from his table
"Wait a second. I found this receipt with CG... The receipt is from your place which means CG was here."

"Uh... yes it seems she was. Why were you peeking around in her stuff?"

Press for more info? (yes/no)

>yes
"Don't change the topic. Why was CG here?"

"Look I don't really know. She came here, stayed for a bit... Wait. There was one thing that was kind of suspicious, as soon as she saw a man running past she quickly left and went the other way. I don't know what that was all about, but it seemed like she knew him. While she was leaving, she dropped this piece of paper, I couldn't give it back to her."
Steve hands you CG's Note
"Ok, I have to go tend to some stuff, you really should leave."

Front of Steve's
Incandescent bulbs spilled their light over the entrance, bringing to attention the dilapidated and ignored posters on the glass wall. I could see that the inside was full of people, full of life, and the coldness of the outside hit me even harder. To the north of me stood Steve's Fine Establishment.

You can see Door to Steve's and Posters here.

Steve isn't here.

>w
Crimson Way
I stepped out into the street, and felt the crackling of the lamp above me, like a barber's clippers slowly clipping away my sanity. The idle droning of cars was only cut short by a horn once in a while, breaking the monotony. If I remembered correctly Steve's Fine Establishment was a short walk east of here. I had never really gone west of the alley, that area tended to be too filled with hoodlums to warrant a visit. Maybe I could find CG's killer there? I also remembered Grove Street to my south, which had Rakesh's Indian Restaurant as well as an apartment complex.

* * *

>w
You can't go that way.

>e
Crimson Way
I stepped out into the street, and felt the crackling of the lamp above me, like a barber's clippers slowly clipping away my sanity. The idle droning of cars was only cut short by a horn once in a while, breaking the monotony. If I remembered correctly Steve's Fine Establishment was a short walk east of here. I had never really gone west of the alley, that area tended to be too filled with hoodlums to warrant a visit. Maybe I could find CG's killer there? I also remembered Grove Street to my south, which had Rakesh's Indian Restaurant as well as an apartment complex.

* * *

>look
I looked around and noticed a small key on the register desk. Maybe Rakesh had left it behind?

Rakesh's Restaurant
The warm smell of fresh indian food hit my nose as soon as I waked in. 

You can see Register Key and Register Drawer (closed) here.

>take key
Taken.

>unlock drawer
What do you want to unlock Register Drawer with?

>key
You unlock Register Drawer.

* * *

>open drawer
You open Register Drawer, revealing Money and Torn paper.

>take paper
Which do you mean, Torn paper or Paper from Rakesh's?

>torn
Taken.

I noticed this torn scrap fit perfectly with the half of CG's note. I combined the two together to read "East from Grove Street
Knocks: three short knocks then two long knocks
Apartment 36"

>inv
You are carrying:
  Register Key
  CG's Note
  Receipt from Steve's
  Clues
    Paper from Rakesh's
    CG's body

>x cg's note
A note written distinctly in CG's handwriting. Combining the halves I found in Steve's and Rakesh's it now reads "East from Grove Street
Knocks: three short knocks then two long knocks
Apartment 36"

* * *

>pakistan terror
Warming causes internal Pakistan collapse creating an opening for nuclear theft.
Klare 1-13
extreme drought creating an opening for radical Islamists aligned with elements of the armed forces to seize some of the country's 150 or so nuclear weapons. The risk to Pakistan from climate change is acute. landowners dominate politics climate change is bound to make the problem worse. Pakistanis expected to suffer a highly stressed environmental system on which a tense society depends can be a source of political instability and how that source can intensify when climate events put increased stress on the system

The theft requires both motive and capability. Al-Qaeda has both.
Hundley 18
nuclear weapons will fall into the hands of terrorists. The weapons will be stored in Karachi or Balochistan al-Qaeda has shown a willingness and capability the ease with which the attackers entered and their focus suggested inside help.

That causes US-Russia nuclear war.
Barrett et al. 13
War involving the U.S. and Russian nuclear arsenals the largest of any nations could lead to extinction Nuclear war including unauthorized launch safeguards over nuclear weapons fail they have remained ready to launch nuclear missiles terrorist groups  might cause attacks on either the US or Russia that resemble some kind of nuclear attack by the other nation by exploding a stolen bomb Al Qaeda has sought to obtain nuclear weapons and to use them against the US

Using nukes means Earth explodes, causes extinction
Chalko 03
Consequences of using modern nuclear weapons can be far more serious neutron radiation reach significant depths in the planetary interior causes increased nuclear heat generation in the planetary interior The TRUE danger of modern nuclear weaponry is that their neutron radiation is capable to induce global overheating of the planetary interior cause the entire planet to explode

* * *

>pakistan terror
Warming causes internal Pakistan collapse creating an opening for nuclear theft.
Klare 1-13
extreme drought creating an opening for radical Islamists aligned with elements of the armed forces to seize some of the country's 150 or so nuclear weapons. The risk to Pakistan from climate change is acute. landowners dominate politics climate change is bound to make the problem worse. Pakistanis expected to suffer a highly stressed environmental system on which a tense society depends can be a source of political instability and how that source can intensify when climate events put increased stress on the systemThe theft requires both motive and capability. Al-Qaeda has both.
Hundley 18
nuclear weapons will fall into the hands of terrorists. The weapons will be stored in Karachi or Balochistan al-Qaeda has shown a willingness and capability the ease with which the attackers entered and their focus suggested inside help.
That causes US-Russia nuclear war.
Barrett et al. 13
War involving the U.S. and Russian nuclear arsenals the largest of any nations could lead to extinction Nuclear war including unauthorized launch safeguards over nuclear weapons fail they have remained ready to launch nuclear missiles terrorist groups  might cause attacks on either the US or Russia that resemble some kind of nuclear attack by the other nation by exploding a stolen bomb Al Qaeda has sought to obtain nuclear weapons and to use them against the USUsing nukes means Earth explodes, causes extinction
Chalko 03
Consequences of using modern nuclear weapons can be far more serious neutron radiation reach significant depths in the planetary interior causes increased nuclear heat generation in the planetary interior The TRUE danger of modern nuclear weaponry is that their neutron radiation is capable to induce global overheating of the planetary interior cause the entire planet to explode

>util
That's not a verb I recognise.

* * *

>baudrillard
God is dead but the hyperreal is alive and kicking. Our forms of information and communication are only signifiers - words are references to the real. Originally, the real thing created what references it, but Baudrillard indicates that in the age of mass media we no longer create signifiers to refer to reality, we create reality based on our signifiers. For example, Coca-cola is just another liquid but through our interpretation of it via ads and discourse we give it a brand and a certain legitimacy. Then, through a circular process, signs start to only signify other signs, not anything real, i.e. my interpretation of something will eventually be just based on your interpretation of it, which is based on someone else's. Thus, the creation of meaning is no longer about real things but just an exchange of empty signifiers devoid of real meaning. This is the hyperreality and it neutralizes any truth in messages and medium. The hyperreal is fundamentally unstable because there is nothing behind it to support it -- it is supposed to implode from lack of power but it lives on meanings given to it by people who assume it has meaning. The explosive idealism of the 1AC prevents the coming implosion of hyperreality by giving meaning to the meaningless - only embracing the implosion can collapse the simulation.

The 1AC's revolutionary attempt to revive the university fails because their method of meaning production is already dead - their mythical nostalgia for a sense of justice keeps the already corrupted system alive. Only the alternative, by embracing the rotting of these institutions, can dissolve the system.

The alternative is to recognize radical alterity - refusing to ascribe a fixed identity to the Other means the system cannot assimilate the Other
That means order-driven solutions like the aff's policy approach can't solve - they paradoxically increase disorder in the system which causes their own impacts

* * *

>disclosure shell
Interpretation: Debaters must open source all cards read in their constructive speeches on their page of the HSLD wiki after each round with highlighting

Violation: screenshot

Standards:
1. Debate resource inequities - open source helps novices, independents, and lowly funded debaters. Stealing evidence is good. Big schools will backchannel ev anyways, all you do is hurt small schools. Resource inequities control how people engage in debate which is key to accessibility.
Antonoucci 05
Open source systems are preferable It's better to share the wealth open systems may be the only answer to resource inequities. Every other proposal fails open source would reduce entry barriers especially on the novice level the option can't hurt open source system would fundamentally change the evidence economy without targetting anyone

2. Evidence ethics - Open source helps verify cards aren't miscut. Prep time is not enough to actually check their sources. Ev ethics is a voter otherwise there would be no debate, just who can read the most miscut evidence. People get fired and expelled for this in the real world, it's a good norm.

3. Clash - If debaters know what exactly their opponent reads and not just what the article says they'll be able to better engage in the round. Key to education cuz we get more in-depth debate. 

4. Wiki rules - it says you should open source, means this shell isn't arbitrary and there IS a brightline for disclosure, no "endless disclosure" args.

5. Reciprocity - most debaters open source. My opponent gets access to cites and cards for cases and prep, which improves quality ground and means they can predict what other people are running, but we can't predict them. This outweighs-a) every reason disclosure is good is an advantage for them and not me, view their counter-interp with a grain of salt since it's self-serving. Reciprocity key to fairness-ensures equal access to the ballot.

Voters:
1. Fairness is a voter because debate is a competitive activity
2. Education is a voter because it's the reason schools fund debate, we wouldn't have debate without it
3. Accessibility is a voter and comes first since rejecting it is morally abhorrent and it's a prereq to debate

Drop the debater
1. Rectify time spent on theory
2. Deter future abuse

Competing interps
1. Reasonability is arbitrary and invites judge intervention
2. Reasonability creates a race to the bottom where people try to find out how abusive they can be

No RVIs
1. They're illogical
2. They chill abuse checking
3. Incentivizes people to bait theory then win the RVI
4. It is your responsibility to be fair and educational

* * *

>util
That's not a verb I recognise.

* * *

>kk
That's not a verb I recognise.

* * *

>se
You can't go that way.

>s
Crimson Way
I stepped out into the street, and felt the crackling of the lamp above me, like a barber's clippers slowly clipping away my sanity. The idle droning of cars was only cut short by a horn once in a while, breaking the monotony. If I remembered correctly Steve's Fine Establishment was a short walk east of here. I had never really gone west of the alley, that area tended to be too filled with hoodlums to warrant a visit. Maybe I could find CG's killer there?

* * *

>e
Front of Steve's
Incandescent bulbs spilled their light over the entrance, bringing to attention the dilapidated and ignored posters on the glass wall. I could see that the inside was full of people, full of life, and the coldness of the outside hit me even harder. To the north of me stood Steve's Fine Establishment.

You can see Posters here.

>n
You can't go that way.

* * *

>w
You can't go that way.

* * *

>s
Crimson Way
I stepped out into the street, and felt the crackling of the lamp above me, like a barber's clippers slowly clipping away my sanity. The idle droning of cars was only cut short by a horn once in a while, breaking the monotony. If I remembered correctly Steve's Fine Establishment was a short walk east of here. I had never really gone west of the alley, that area tended to be too filled with hoodlums to warrant a visit. Maybe I could find CG's killer there?

>w
Central Park
A hangout for all kinds of colorful characters and clueless tourists. Trees obscured my view from every direction, and I saw the usual goons scattered about. It was eerily quiet out; the only thing I could hear ofher than the crickets and creatures was the thumping of my own heart. All around me I could see the paths of the park branching out like the branches of its many trees.

You can see Mike here.

>ask mike about Front of Steve's
Mike turned to face me. 
There is no reply.

>e
Mike sat back down on his bench.

Crimson Way
If I remembered correctly Steve's Fine Establishment was a short walk east of here. I had never really gone west of the alley, that area tended to be too filled with hoodlums to warrant a visit. Maybe I could find CG's killer there?

>e
Front of Steve's
Incandescent bulbs spilled their light over the entrance, bringing to attention the dilapidated and ignored posters on the glass wall. I could see that the inside was full of people, full of life, and the coldness of the outside hit me even harder. To the north of me stood Steve's Fine Establishment.

You can see Posters here.

>look
Front of Steve's
To the north of me stood Steve's Fine Establishment.

You can see Posters here.

>n
I stepped forward and a muscular gentleman held out his hand. He grunted in my direction, as if cueing me to say something.

Enter password:

* * *

>swordfish
The bouncer stepped to the side, letting me pass.

>n
Steve's Fine Establishment
The comforting smell of flannel and fermented yeast smothered me when I walked in. I knew the owner Steve personally, he was an old friend of mine, but as of recent times I hadn't been keeping up with him as much as I wished to. It had been a few months since I'd last seen him. Steve stood behind the table, tending to his customers. All around me people sat eating food and consuming fermented yeast in different flavors.

You can see Steve here.

>s
Front of Steve's
To the north of me stood Steve's Fine Establishment.

You can see Posters here.

>w
Crimson Way
If I remembered correctly Steve's Fine Establishment was a short walk east of here. I had never really gone west of the alley, that area tended to be too filled with hoodlums to warrant a visit. Maybe I could find CG's killer there?

* * *

>w
You can't go that way.

>ask mike about Front of Steve's
Mike turned to face me. 
There is no reply.

>Ask mike about the strange man
There is no reply.

>ask mike about cg
"Did you see CG any time recently? Specifically in the last few days?"

Mike thought for a second and said, "Hmm, I did see her pass through the park once, and there was a weird guy following her... I don't exactly remember what he looked like but he had a beige sports coat on, the type that you'd wear to be polite since you can't afford a proper suit."

"A strange man," I thought to myself, "this whole business was strange, not much about the man could make it stranger."

>ask mike about the strange man
"What exactly did the man look like? Do you remember anything specific about him?"

"I told you he was wearing a sports coat. That's all I can really remember.

* * *

>n
End of alley
As I walked towards the end of the alley the walls around me loomed with their neverending height. It stank of rotten food and cigarettes, which all seemed to emanate from the dumpster in front of me. A glint from the dumpster caught my eye.

A green dumpster sat still at the end of the alley.

>n
You can't go that way.

>open dumpster
You open Dumpster, revealing Knife.

* * *

>take knife
Looking through the dumpster I saw a knife tossed there, seemingly having fulfilled its purpose. Blood covered the blade and I shuddered thinking where it came from. I considered that it might draw suspicion on me if I were carrying around a bloody knife, but I picked it up. It might come in handy...

>drop knife
Dropped.

>take it
Looking through the dumpster I saw a knife tossed there, seemingly having fulfilled its purpose. Blood covered the blade and I shuddered thinking where it came from. I considered that it might draw suspicion on me if I were carrying around a bloody knife, but I picked it up. It might come in handy...

>s
Crime scene
As my eyes glanced over the scene I saw CG lying in front of me, and a dumpster to my north.

You can see CG here.

>s
Crimson Way
I stepped out into the street, and felt the crackling of the lamp above me, like a barber's clippers slowly clipping away my sanity. The idle droning of cars was only cut short by a horn once in a while, breaking the monotony. If I remembered correctly Steve's Fine Establishment was a short walk east of here. I had never really gone west of the alley, that area tended to be too filled with hoodlums to warrant a visit. Maybe I could find CG's killer there?

* * *

>n
I stepped forward and a muscular gentleman held out his hand. He grunted in my direction, as if cueing me to say something.

Enter password:

>ts
The bouncer stood there; it seemed I had gotten the password wrong.

>ts
That's not a verb I recognise.

>drop knife
Dropped.

>n
I stepped forward and a muscular gentleman held out his hand. He grunted in my direction, as if cueing me to say something.

Enter password:

* * *

>look
Front of Steve's
To the north of me stood Steve's Fine Establishment.

You can see Knife and Posters here.

* * *

I beg your pardon?

>s
Crimson Way
I stepped out into the street, and felt the crackling of the lamp above me, like a barber's clippers slowly clipping away my sanity. The idle droning of cars was only cut short by a horn once in a while, breaking the monotony. If I remembered correctly Steve's Fine Establishment was a short walk east of here. I had never really gone west of the alley, that area tended to be too filled with hoodlums to warrant a visit. Maybe I could find CG's killer there?

* * *

>e
Front of Steve's
Incandescent bulbs spilled their light over the entrance, bringing to attention the dilapidated and ignored posters on the glass wall. I could see that the inside was full of people, full of life, and the coldness of the outside hit me even harder. To the north of me stood Steve's Fine Establishment.

You can see Door to Steve's and Posters here.

>xw
That's not a verb I recognise.

>s
You can't go that way.

>w
Crimson Way
I stepped out into the street, and felt the crackling of the lamp above me, like a barber's clippers slowly clipping away my sanity. The idle droning of cars was only cut short by a horn once in a while, breaking the monotony. If I remembered correctly Steve's Fine Establishment was a short walk east of here. I had never really gone west of the alley, that area tended to be too filled with hoodlums to warrant a visit. Maybe I could find CG's killer there?

* * *

>damn
That's not a verb I recognise.

>damn
That's not a verb I recognise.

>dam
That's not a verb I recognise.

>damn
That's not a verb I recognise.

>damk
That's not a verb I recognise.

>damn
That's not a verb I recognise.

>end
That's not a verb I recognise.

>end the stoay
That's not a verb I recognise.

* * *

>look
Crime scene
As my eyes glanced over the scene I saw CG lying in front of me, and a dumpster to my north.

You can see CG here.

I beg your pardon?

* * *

>look
Crime scene
As my eyes glanced over the scene I saw CG lying in front of me, and a dumpster to my north.

You can see CG here.

>s
Crimson Way
I stepped out into the street, and felt the crackling of the lamp above me, like a barber's clippers slowly clipping away my sanity. The idle droning of cars was only cut short by a horn once in a while, breaking the monotony. If I remembered correctly Steve's Fine Establishment was a short walk east of here. I had never really gone west of the alley, that area tended to be too filled with hoodlums to warrant a visit. Maybe I could find CG's killer there?

* * *

>swordfish
The muscular gentleman grunted approvingly.

Steve's Fine Establishment
The comforting smell of flannel and fermented yeast smothered me when I walked in. I had heard about this place from a few of my friends, but had never actually visited it. Steve stood behind the table, tending to his customers. All around me people sat eating food and consuming fermented yeast in different flavors.

You can see Steve here.

>look
Steve's Fine Establishment
Steve stood behind the table, tending to his customers. All around me people sat eating food and consuming fermented yeast in different flavors.

You can see Steve here.

>talk to steve
"Hey Steve, how've you been?"

"Not too bad."

* * *

>ask steve about cg
"Have you seen CG around recently?"

"No, I haven't... But you know how she was, you could blink twice and she'd be gone."

>ask steve about receipt
There is no reply.

>s
Steve waved and went to another customer.

Front of Steve's
To the north of me stood Steve's Fine Establishment.

You can see Posters here.

* * *

I beg your pardon?

>look
Front of Steve's
To the north of me stood Steve's Fine Establishment.

You can see Posters here.

* * *

>go east
You can't go that way.

>go west
Crimson Way
If I remembered correctly Steve's Fine Establishment was a short walk east of here. I had never really gone west of the alley, that area tended to be too filled with hoodlums to warrant a visit. Maybe I could find CG's killer there?

* * *

>x cg pocket
I looked in her pocket and saw the corner of a neatly creased piece of paper sticking out.

* * *

>take paper
I unfolded the paper and saw a receipt from Steve's Fine Establishment. I knew where that was, I had been there a couple of times. It wasn't a place you'd go with your friends, but it was still a nice place. The owner wasn't too bad either, something I couldn't say about half the places I knew.

>inv
You are carrying:
  Receipt from Steve's
  Clues

>s
Crimson Way
I stepped out into the street, and felt the crackling of the lamp above me, like a barber's clippers slowly clipping away my sanity. The idle droning of cars was only cut short by a horn once in a while, breaking the monotony. If I remembered correctly Steve's Fine Establishment was a short walk east of here. I had never really gone west of the alley, that area tended to be too filled with hoodlums to warrant a visit. Maybe I could find CG's killer there?

* * *

>inv
You are carrying:
  CG's Note (Torn)
  Receipt from Steve's
  Clues

Press for more info? (y/n)

>x cg's note
A note written distinctly in CG's handwriting. It reads "East from Grove Street
Knocks: .-.. . - / -- . / .. -.
Apartm-"
The note cuts off, the tear seems to precise to be an accident.

Press for more info? (y/n)

* * *

>look
Front of Steve's
Incandescent bulbs spilled their light over the entrance, bringing to attention the dilapidated and ignored posters on the glass wall. I could see that the inside was full of people, full of life, and the coldness of the outside hit me even harder. To the north of me stood Steve's Fine Establishment.

You can see Door to Steve's and Posters here.

>open door
It seems to be locked.

>close door
That's already closed.

>unlock door
What do you want to unlock Door to Steve's with?

>receipt
That doesn't seem to fit the lock.

>n
Steve's Fine Establishment
The comforting smell of flannel and fermented yeast smothered me when I walked in. I had heard about this place from a few of my friends, but had never actually visited it. Steve stood behind the table, tending to his customers. All around me people sat eating food and consuming fermented yeast in different flavors.

You can see Door to Steve's and Steve here.

>s
(first opening Door to Steve's)
It seems to be locked.

>s
(first opening Door to Steve's)
It seems to be locked.

I beg your pardon?

>s
(first opening Door to Steve's)
It seems to be locked.

* * *

>swordfish
The muscular gentleman grunted approvingly.

Steve's Fine Establishment
The comforting smell of flannel and fermented yeast smothered me when I walked in. I had heard about this place from a few of my friends, but had never actually visited it. Steve stood behind the table, tending to his customers. All around me people sat eating food and consuming fermented yeast in different flavors.

You can see Door to Steve's and Steve here.

>s
(first opening Door to Steve's)

Front of Steve's
To the north of me stood Steve's Fine Establishment.

You can see Door to Steve's and Posters here.

>n
Steve's Fine Establishment
Steve stood behind the table, tending to his customers. All around me people sat eating food and consuming fermented yeast in different flavors.

You can see Door to Steve's and Steve here.

>s
Front of Steve's
To the north of me stood Steve's Fine Establishment.

You can see Door to Steve's and Posters here.

>n
Steve's Fine Establishment
Steve stood behind the table, tending to his customers. All around me people sat eating food and consuming fermented yeast in different flavors.

You can see Door to Steve's and Steve here.

>x door to steve's
You see nothing special about Door to Steve's.

>ask steve about receipt
Steve looked up from his table
"Wait a second. I found this receipt with CG... The receipt is from you. CG was here."

"Uh... yes it seems she was. Why were you peeking around in her stuff?"

Press for more info? (y/n)

>y
That was a rhetorical question.

Press for more info? (y/n)

>yes
"Don't change the topic. Why was CG here?"

"Look I don't really know. She came here, stayed for a bit... Wait. There was one thing that was kind of suspicious, as soon as she saw a man running past she quickly left and went the other way. I don't know what that was all about, but it seemed like she knew him. While she was leaving, she dropped this piece of paper, I couldn't give it back to her."
Steve hands you CG's Note
"Look, I have to go tend to some stuff, you should leave."

Front of Steve's
To the north of me stood Steve's Fine Establishment.

You can see Door to Steve's and Posters here.

Press for more info? (y/n)

>n
Steve's Fine Establishment
Steve stood behind the table, tending to his customers. All around me people sat eating food and consuming fermented yeast in different flavors.

You can see Door to Steve's and Steve here.

Press for more info? (y/n)

>s
Steve waved and went to another customer.

Front of Steve's
To the north of me stood Steve's Fine Establishment.

You can see Door to Steve's and Posters here.

Press for more info? (y/n)

>n
Steve's Fine Establishment
Steve stood behind the table, tending to his customers. All around me people sat eating food and consuming fermented yeast in different flavors.

You can see Door to Steve's and Steve here.

Press for more info? (y/n)

>s
Front of Steve's
To the north of me stood Steve's Fine Establishment.

You can see Door to Steve's and Posters here.

Press for more info? (y/n)

>n
Steve's Fine Establishment
Steve stood behind the table, tending to his customers. All around me people sat eating food and consuming fermented yeast in different flavors.

You can see Door to Steve's and Steve here.

Press for more info? (y/n)

* * *

>n
You can't go that way.

>ask steve about receipt
Steve looked up from his table
"Wait a second. I found this receipt with CG... The receipt is from your place which means CG was here."

"Uh... yes it seems she was. Why were you peeking around in her stuff?"

Press for more info? (yes/no)

* * *

>look
Front of Steve's
Incandescent bulbs spilled their light over the entrance, bringing to attention the dilapidated and ignored posters on the glass wall. I could see that the inside was full of people, full of life, and the coldness of the outside hit me even harder. To the north of me stood Steve's Fine Establishment.

You can see Door to Steve's and Posters here.

>x door
You see nothing special about Door to Steve's.

>open door
It seems to be locked.

>n
Steve's Fine Establishment
The comforting smell of flannel and fermented yeast smothered me when I walked in. I had heard about this place from a few of my friends, but had never actually visited it. Steve stood behind the table, tending to his customers. All around me people sat eating food and consuming fermented yeast in different flavors.

You can see Door to Steve's and Steve here.

* * *

>s
(first opening Door to Steve's)
It seems to be locked.

>unlock door
What do you want to unlock Door to Steve's with?

* * *

>x door
You see nothing special about Door to Steve's.

>w
Crimson Way
I stepped out into the street, and felt the crackling of the lamp above me, like a barber's clippers slowly clipping away my sanity. The idle droning of cars was only cut short by a horn once in a while, breaking the monotony. If I remembered correctly Steve's Fine Establishment was a short walk east of here. I had never really gone west of the alley, that area tended to be too filled with hoodlums to warrant a visit. Maybe I could find CG's killer there?

>e
Front of Steve's
Incandescent bulbs spilled their light over the entrance, bringing to attention the dilapidated and ignored posters on the glass wall. I could see that the inside was full of people, full of life, and the coldness of the outside hit me even harder. To the north of me stood Steve's Fine Establishment.

You can see Door to Steve's and Posters here.

>n
Steve's Fine Establishment
The comforting smell of flannel and fermented yeast smothered me when I walked in. I had heard about this place from a few of my friends, but had never actually visited it. Steve stood behind the table, tending to his customers. All around me people sat eating food and consuming fermented yeast in different flavors.

You can see Door to Steve's and Steve here.

* * *

>swordfish
The muscular gentleman grunted approvingly.

Steve's Fine Establishment
The comforting smell of flannel and fermented yeast smothered me when I walked in. I had heard about this place from a few of my friends, but had never actually visited it. Steve stood behind the table, tending to his customers. All around me people sat eating food and consuming fermented yeast in different flavors.

You can see Door to Steve's and Steve here.

>x door
You see nothing special about Door to Steve's.

>ask steve about receipt
Steve looked up from his table
"Wait a second. I found this receipt with CG... The receipt is from your place which means CG was here."

"Uh... yes it seems she was. Why were you peeking around in her stuff?"

Press for more info? (yes/no)

* * *

>look
Front of Steve's
Incandescent bulbs spilled their light over the entrance, bringing to attention the dilapidated and ignored posters on the glass wall. I could see that the inside was full of people, full of life, and the coldness of the outside hit me even harder. To the north of me stood Steve's Fine Establishment.

You can see Door to Steve's and Posters here.

>n
(first opening Door to Steve's)
It seems to be locked.

* * *

>e
Front of Steve's
Incandescent bulbs spilled their light over the entrance, bringing to attention the dilapidated and ignored posters on the glass wall. I could see that the inside was full of people, full of life, and the coldness of the outside hit me even harder. To the north of me stood Steve's Fine Establishment.

You can see Door to Steve's and Posters here.

>nh
That's not a verb I recognise.

>n
I stepped forward and a muscular gentleman held out his hand. He grunted in my direction, as if cueing me to say something.

Enter password:

* * *

>swordfish
The muscular gentleman grunted approvingly.

Steve's Fine Establishment
The comforting smell of flannel and fermented yeast smothered me when I walked in. I had heard about this place from a few of my friends, but had never actually visited it. Steve stood behind the table, tending to his customers. All around me people sat eating food and consuming fermented yeast in different flavors.

You can see Door to Steve's and Steve here.

>ask steve about receip
Steve looked up from his table
There is no reply.

>ask steve about receipt
"Wait a second. I found this receipt with CG... The receipt is from your place which means CG was here."

"Uh... yes it seems she was. Why were you peeking around in her stuff?"

Press for more info? (yes/no)

* * *

>tsr
That's not a verb I recognise.

Press for more info? (yes/no)

>inv
You are carrying:
  Receipt from Steve's
  Clues

Press for more info? (yes/no)

* * *

>s
Crimson Way
I stepped out into the street, and felt the crackling of the lamp above me, like a barber's clippers slowly clipping away my sanity. The idle droning of cars was only cut short by a horn once in a while, breaking the monotony. If I remembered correctly Steve's Fine Establishment was a short walk east of here. I had never really gone west of the alley, that area tended to be too filled with hoodlums to warrant a visit. Maybe I could find CG's killer there?

>n
Crime scene
As my eyes glanced over the scene I saw CG lying in front of me, and a dumpster to my north.

You can see CG here.

>s
Crimson Way
I stepped out into the street, and felt the crackling of the lamp above me, like a barber's clippers slowly clipping away my sanity. The idle droning of cars was only cut short by a horn once in a while, breaking the monotony. If I remembered correctly Steve's Fine Establishment was a short walk east of here. I had never really gone west of the alley, that area tended to be too filled with hoodlums to warrant a visit. Maybe I could find CG's killer there?

* * *

>ask steve about receipt
Steve looked up from his table
"Wait a second. I found this receipt with CG... The receipt is from your place which means CG was here."

"Uh... yes it seems she was. Why were you peeking around in her stuff?"

Press for more info? (yes/no)

>yes"
I only understood you as far as wanting to yes.

Press for more info? (yes/no)

>yes
"Don't change the topic. Why was CG here?"

"Look I don't really know. She came here, stayed for a bit... Wait. There was one thing that was kind of suspicious, as soon as she saw a man running past she quickly left and went the other way. I don't know what that was all about, but it seemed like she knew him. While she was leaving, she dropped this piece of paper, I couldn't give it back to her."
Steve hands you CG's Note
"Ok, I have to go tend to some stuff, you really should leave."

Front of Steve's
Incandescent bulbs spilled their light over the entrance, bringing to attention the dilapidated and ignored posters on the glass wall. I could see that the inside was full of people, full of life, and the coldness of the outside hit me even harder. To the north of me stood Steve's Fine Establishment.

You can see Door to Steve's and Posters here.

Steve isn't here.

* * *

>look
Front of Steve's
Incandescent bulbs spilled their light over the entrance, bringing to attention the dilapidated and ignored posters on the glass wall. I could see that the inside was full of people, full of life, and the coldness of the outside hit me even harder. To the north of me stood Steve's Fine Establishment.

You can see Door to Steve's and Posters here.

>n
Steve's Fine Establishment
The comforting smell of flannel and fermented yeast smothered me when I walked in. I had heard about this place from a few of my friends, but had never actually visited it. Steve stood behind the table, tending to his customers. All around me people sat eating food and consuming fermented yeast in different flavors.

You can see Door to Steve's and Steve here.

>n
You can't go that way.

>s
(first opening Door to Steve's)
It seems to be locked.

* * *

>take paper
You can't see any such thing.

>x cg's pocket
I looked in her pocket and saw the corner of a neatly creased piece of paper sticking out.

>take paper
I unfolded the paper and saw a receipt from Steve's Fine Establishment. I knew where that was, I had been there a couple of times. It wasn't a place you'd go with your friends, but it was still a nice place. The owner wasn't too bad either, something I couldn't say about half the places I knew.

* * *

>n
You can't go that way.

>s
(first opening Door to Steve's)

Front of Steve's
To the north of me stood Steve's Fine Establishment.

You can see Door to Steve's and Posters here.

* * *

>n
Steve's Fine Establishment
Steve stood behind the table, tending to his customers. All around me people sat eating food and consuming fermented yeast in different flavors.

You can see Door to Steve's and Steve here.

>ask steve about receipt
Steve looked up from his table
"Wait a second. I found this receipt with CG... The receipt is from you. CG was here."

"Uh... yes it seems she was. Why were you peeking around in her stuff?"

Press for more info? (y/n)

>yes
"Don't change the topic. Why was CG here?"

"Look I don't really know. She came here, stayed for a bit... Wait. There was one thing that was kind of suspicious, as soon as she saw a man running past she quickly left and went the other way. I don't know what that was all about, but it seemed like she knew him. While she was leaving, she dropped this piece of paper, I couldn't give it back to her."
Steve hands you CG's Note
"Ok, I have to go tend to some stuff, you really should leave."

Front of Steve's
To the north of me stood Steve's Fine Establishment.

You can see Door to Steve's and Posters here.

Press for more info? (y/n)

>n
Steve's Fine Establishment
Steve stood behind the table, tending to his customers. All around me people sat eating food and consuming fermented yeast in different flavors.

You can see Door to Steve's and Steve here.

Press for more info? (y/n)

* * *

>s
Steve waved and went to another customer.

Front of Steve's
To the north of me stood Steve's Fine Establishment.

You can see Door to Steve's and Posters here.

Press for more info? (y/n)

>lock door
What do you want to lock Door to Steve's with?

Press for more info? (y/n)

>lock door
What do you want to lock Door to Steve's with?

Press for more info? (y/n)

>clues
That's locked at the moment.

Press for more info? (y/n)

>look
Front of Steve's
To the north of me stood Steve's Fine Establishment.

You can see Door to Steve's and Posters here.

Press for more info? (y/n)

>x door
You see nothing special about Door to Steve's.

Press for more info? (y/n)

>lock door to steve's
What do you want to lock Door to Steve's with?

Press for more info? (y/n)

>clues
That's locked at the moment.

Press for more info? (y/n)

* * *

>x cg arm
I only understood you as far as wanting to examine CG.

>x cg left arm
I turned over her left arm, but there was nothing there.

>x cg right arm
I held her right arm up to the lamplight, and in the yellow glow I saw a watch tan, but no watch. Had it been stolen?

>x cg coat
I only understood you as far as wanting to examine CG.

>x cg coat pocket
I only understood you as far as wanting to examine CG.

* * *

>x cg pocket
I looked in her pocket and saw the corner of a neatly creased piece of paper sticking out.

>x cg head
I only understood you as far as wanting to examine CG.

>x cg
I got down and looked at CG, trying to find anything that might lead me to find her murderer. A thick pool of blood spilled out from her head, giving her a devilish halo. I thought it would be best to check her arms, and her coat pocket.

>take paper
I unfolded the paper and saw a receipt from Steve's Fine Establishment. I knew where that was, I had been there a couple of times. It wasn't a place you'd go with your friends, but it was still a nice place. The owner wasn't too bad either, something I couldn't say about half the places I knew.

>inv
You are carrying:
  Receipt from Steve's
  Clues
    CG's body
    CG's watch

>inventory
You are carrying:
  Receipt from Steve's
  Clues
    CG's body
    CG's watch

>l
Crime scene
As my eyes glanced over the scene I saw CG lying in front of me, and a dumpster to my north.

You can see CG here.

>s
Crimson Way
I stepped out into the street, and felt the crackling of the lamp above me, like a barber's clippers slowly clipping away my sanity. The idle droning of cars was only cut short by a horn once in a while, breaking the monotony. If I remembered correctly Steve's Fine Establishment was a short walk east of here. I had never really gone west of the alley, that area tended to be too filled with hoodlums to warrant a visit. Maybe I could find CG's killer there? I also remembered Grove Street to my south, which had Rakesh's Indian Restaurant as well as an apartment complex.

* * *

>e
Front of Steve's
Incandescent bulbs spilled their light over the entrance, bringing to attention the dilapidated and ignored posters on the glass wall. I could see that the inside was full of people, full of life, and the coldness of the outside hit me even harder. To the north of me stood Steve's Fine Establishment.

You can see Door to Steve's and Posters here.

>open door to steve's
You open Door to Steve's.

>l
Front of Steve's
Incandescent bulbs spilled their light over the entrance, bringing to attention the dilapidated and ignored posters on the glass wall. I could see that the inside was full of people, full of life, and the coldness of the outside hit me even harder. To the north of me stood Steve's Fine Establishment.

You can see Door to Steve's and Posters here.

* * *

>swordfish
The muscular gentleman grunted approvingly.

Steve's Fine Establishment
The comforting smell of flannel and fermented yeast smothered me when I walked in. I had heard about this place from a few of my friends, but had never actually visited it. Steve stood behind the table, tending to his customers. All around me people sat eating food and consuming fermented yeast in different flavors.

You can see Door to Steve's and Steve here.

>open door
That's already open.

>n
You can't go that way.

* * *

>w
You can't go that way.

>steve's
That's not a verb I recognise.

>l
Steve's Fine Establishment
The comforting smell of flannel and fermented yeast smothered me when I walked in. I had heard about this place from a few of my friends, but had never actually visited it. Steve stood behind the table, tending to his customers. All around me people sat eating food and consuming fermented yeast in different flavors.

You can see Door to Steve's and Steve here.

>s
Front of Steve's
Incandescent bulbs spilled their light over the entrance, bringing to attention the dilapidated and ignored posters on the glass wall. I could see that the inside was full of people, full of life, and the coldness of the outside hit me even harder. To the north of me stood Steve's Fine Establishment.

You can see Door to Steve's and Posters here.

>n
Steve's Fine Establishment
The comforting smell of flannel and fermented yeast smothered me when I walked in. I had heard about this place from a few of my friends, but had never actually visited it. Steve stood behind the table, tending to his customers. All around me people sat eating food and consuming fermented yeast in different flavors.

You can see Door to Steve's and Steve here.

>s
Front of Steve's
Incandescent bulbs spilled their light over the entrance, bringing to attention the dilapidated and ignored posters on the glass wall. I could see that the inside was full of people, full of life, and the coldness of the outside hit me even harder. To the north of me stood Steve's Fine Establishment.

You can see Door to Steve's and Posters here.

* * *

>n
Steve's Fine Establishment
The comforting smell of flannel and fermented yeast smothered me when I walked in. I had heard about this place from a few of my friends, but had never actually visited it. Steve stood behind the table, tending to his customers. All around me people sat eating food and consuming fermented yeast in different flavors.

You can see Door to Steve's and Steve here.

>steve
That's not a verb I recognise.

>say hi to steve
"Hey Steve, how've you been?"

"Not too bad."

>greet steve
You are already talking to Steve.

>ask steve about cg
"Have you seen CG around recently?"

"No, I haven't... But you know how she was, you could blink twice and she'd be gone."

* * *

>ask steve about receipt
"Wait a second. I found this receipt with CG... The receipt is from your place which means CG was here."

"Uh... yes it seems she was. Why were you peeking around in her stuff?"

Press for more info? (yes/no)

>y
That was a rhetorical question.

Press for more info? (yes/no)

>yes
"Don't change the topic. Why was CG here?"

"Look I don't really know. She came here, stayed for a bit... Wait. There was one thing that was kind of suspicious, as soon as she saw a man running past she quickly left and went the other way. I don't know what that was all about, but it seemed like she knew him. While she was leaving, she dropped this piece of paper, I couldn't give it back to her."
Steve hands you CG's Note
"Ok, I have to go tend to some stuff, you really should leave."

Front of Steve's
Incandescent bulbs spilled their light over the entrance, bringing to attention the dilapidated and ignored posters on the glass wall. I could see that the inside was full of people, full of life, and the coldness of the outside hit me even harder. To the north of me stood Steve's Fine Establishment.

You can see Door to Steve's and Posters here.

Steve isn't here.

>inv
You are carrying:
  CG's Note (Torn)
  Receipt from Steve's
  Clues
    CG's body
    CG's watch

>x cg's note
A note written distinctly in CG's handwriting. It reads "East from Grove Street
Knocks: three short knocks then two long knocks
Apartm-"
The note cuts off, the tear seems too precise to be an accident.

* * *

This game is a work of fiction. Any similarity to persons living or dead, or actual events is purely coincidental and was not the intent of the creator. Enjoy...

ISAAC 2
An Interactive Fiction by Shreeram Modi (baked__shrimp)
Release 1 / Serial number 210528 / Inform 7 build 6M62 (I6/v6.33 lib 6/12N) SD

Intro

This is a text adventure/interactive fiction game. Do you want a tutorial? (yes/no)

>justify util
Please choose yes or no
Do you want trigger warnings? (yes/no)

>no
Crime scene
I hadn't even known her for that long - CG - but her loss nonetheless pulled strings within my heart that I never knew existed. There she was, lying in the grimiest alleyway in Manhattan and all I could do was stand there powerlessly with my hands in my pockets like I was some chump schoolboy. I knew I had missed something important, more than just the death of a friend, but I was as lost as a jazz pianist in a vaudeville show. The only thing left for me to do would be to get revenge; if not for her sake then to rest my uneasy soul. As my eyes glanced over the scene I saw CG lying in front of me, and a dumpster to my north.

You can see CG here.

>l
Crime scene
As my eyes glanced over the scene I saw CG lying in front of me, and a dumpster to my north.

You can see CG here.

>s
Crimson Way
I stepped out into the street, and felt the crackling of the lamp above me, like a barber's clippers slowly clipping away my sanity. The idle droning of cars was only cut short by a horn once in a while, breaking the monotony. If I remembered correctly Steve's Fine Establishment was a short walk east of here. I had never really gone west of the alley, that area tended to be too filled with hoodlums to warrant a visit. Maybe I could find CG's killer there?

>w
Central Park
A hangout for all kinds of colorful characters and clueless tourists. Trees obscured my view from every direction, and I saw the usual goons scattered about. It was eerily quiet out; the only thing I could hear ofher than the crickets and creatures was the thumping of my own heart. All around me I could see the paths of the park branching out like the branches of its many trees.

You can see Mike and Bush here.

I beg your pardon?

* * *

>t knife
There's no one here to talk to.

>take knife
Looking through the dumpster I saw a knife tossed there, seemingly having fulfilled its purpose. Blood covered the blade and I shuddered thinking where it came from.

>close dumpster
You close Dumpster.

>o
Sorry, that can't be corrected.

>o dumpster
Sorry, that can't be corrected.